Year,Country name,Country iso,Occurrence,Total deaths,Affected,Injured,Homeless,Total affected,Total damage ('000 $)
1965,Bahamas,BHS,1,0,1200,0,0,1200,700
1965,Bangladesh,BGD,3,48921,10060000,600000,5000000,15660000,57700
1965,Fiji,FJI,1,2,10000,0,0,10000,0
1965,Hong Kong (China),HKG,1,5,0,3,200,203,0
1965,Japan,JPN,3,147,30000,770,0,30770,0
1965,Myanmar,MMR,1,100,500000,0,0,500000,1000
1965,Pakistan,PAK,1,10000,0,0,0,0,0
1965,Philippines,PHL,1,37,0,0,0,0,0
1965,Taiwan (China),TWN,2,55,0,166,0,166,0
1965,United States,USA,1,299,0,0,0,0,1420000
1965,Wallis and Futuna Is,WLF,1,0,0,0,0,0,0
1966,American Samoa,ASM,1,90,0,0,0,0,0
1966,Antigua and Barbuda,ATG,1,0,0,0,0,0,0
1966,Bahamas,BHS,2,5,0,3,0,3,15500
1966,Bangladesh,BGD,1,850,1500000,0,300000,1800000,22400
1966,Cuba,CUB,1,5,156000,30,18000,174030,18000
1966,Dominican Rep,DOM,1,74,7000,442,5500,12942,5000
1966,Guadeloupe,GLP,1,25,10000,0,0,10000,70000
1966,Haiti,HTI,1,480,67000,881,0,67881,20000
1966,India,IND,1,18,150000,0,0,150000,4200
1966,Japan,JPN,2,358,13764,121,0,13885,7900
1966,Mexico,MEX,1,14,80000,69,10000,90069,24000
1966,Philippines,PHL,1,18,196000,0,90000,286000,1000
1966,Samoa,WSM,1,10,95000,0,0,95000,600
1966,Solomon Is,SLB,1,3,1000,0,0,1000,0
1966,Taiwan (China),TWN,1,36,5000,21,0,5021,17322
1966,Tokelau,TKL,1,0,0,0,0,0,0
1966,Wallis and Futuna Is,WLF,1,0,0,0,0,0,0
1967,Bangladesh,BGD,2,91,0,200,0,200,0
1967,Cook Is,COK,1,0,0,0,0,0,0
1967,Hong Kong (China),HKG,1,0,1500,3,0,1503,0
1967,India,IND,1,1000,0,0,0,0,0
1967,Japan,JPN,2,290,2655,429,0,3084,0
1967,Martinique,MTQ,1,15,1000,0,0,1000,0
1967,Mauritius,MUS,1,0,20000,24,3500,23524,5000
1967,Mexico,MEX,1,77,271000,0,0,271000,184000
1967,Myanmar,MMR,2,278,157319,200,0,157519,8200
1967,Philippines,PHL,1,107,137000,0,0,137000,26500
1967,Solomon Is,SLB,1,12,0,0,0,0,0
1967,St Lucia,LCA,1,0,0,0,0,0,3000
1967,St Vincent and the Grenad,VCT,1,2,0,0,0,0,4500
1967,Taiwan (China),TWN,1,69,100,67,0,167,0
1967,United States,USA,1,15,0,0,0,0,200000
1968,Bangladesh,BGD,1,118,15093,1045,0,16138,1500
1968,Cuba,CUB,1,0,0,0,0,0,0
1968,Hong Kong (China),HKG,1,0,3000,4,0,3004,0
1968,India,IND,1,7,15000,0,0,15000,0
1968,Japan,JPN,3,124,0,0,0,0,0
1968,Madagascar,MDG,1,29,65000,0,10000,75000,3100
1968,Myanmar,MMR,1,1070,60000,0,30000,90000,2500
1968,New Caledonia,NCL,1,0,0,0,0,0,0
1968,New Zealand,NZL,1,50,1000,0,0,1000,0
1968,Niue,NIU,1,0,0,0,0,0,0
1968,Philippines,PHL,2,50,187330,0,39313,226643,9600
1968,Samoa,WSM,1,0,0,4,0,4,238
1968,Solomon Is,SLB,1,1,0,0,200,200,0
1969,Bangladesh,BGD,1,849,160000,15530,23943,199473,8329
1969,El Salvador,SLV,1,2,4600,40,0,4640,1600
1969,Guatemala,GTM,1,269,10200,0,0,10200,15000
1969,Honduras,HND,1,0,8000,2,0,8002,19000
1969,Hong Kong (China),HKG,1,0,374,0,0,374,0
1969,India,IND,2,800,260000,0,0,260000,8330
1969,Madagascar,MDG,1,81,40000,40,3000,43040,5000
1969,New Caledonia,NCL,1,0,0,0,0,0,3000
1969,Philippines,PHL,1,11,0,0,0,0,0
1969,Taiwan (China),TWN,2,269,40000,408,0,40408,88000
1969,United States,USA,1,323,0,0,0,0,1420000
1970,Australia,AUS,1,13,0,0,0,0,72475
1970,Bangladesh,BGD,1,300000,3648000,0,0,3648000,86400
1970,China P Rep,CHN,1,107,6065,55,7880,14000,0
1970,Cuba,CUB,1,20,0,0,0,0,0
1970,Dominica,DMA,1,0,0,0,0,0,0
1970,Guadeloupe,GLP,1,0,0,0,0,0,0
1970,Italy,ITA,1,35,200,0,0,200,3200
1970,Madagascar,MDG,1,70,10000,0,0,10000,11400
1970,Martinique,MTQ,1,45,5000,0,0,5000,31000
1970,Philippines,PHL,8,3802,1740370,4977,67200,1812547,258399
1970,United States,USA,1,11,0,0,0,0,450000
1971,Australia,AUS,1,3,0,0,0,0,119219
1971,Bangladesh,BGD,1,163,0,0,0,0,0
1971,Honduras,HND,1,0,0,0,0,0,0
1971,Hong Kong (China),HKG,1,115,200,286,1000,1486,0
1971,India,IND,2,9718,4900000,0,2000000,6900000,30000
1971,Japan,JPN,1,135,0,0,0,0,0
1971,Mexico,MEX,1,17,0,0,0,0,0
1971,Nicaragua,NIC,1,35,2800,50,1800,4650,380
1971,Philippines,PHL,4,246,0,11,46500,46511,1290
1971,Viet Nam,VNM,2,112,50000,0,0,50000,0
1972,Fiji,FJI,1,3,120000,0,0,120000,22500
1972,India,IND,2,180,4530000,0,0,4530000,0
1972,Japan,JPN,1,50,0,0,0,0,0
1972,Kiribati,KIR,1,3,700,0,0,700,0
1972,Madagascar,MDG,1,91,2500000,56,10000,2510056,12420
1972,Mauritius,MUS,1,2,25000,16,0,25016,0
1972,New Caledonia,NCL,1,3,0,0,0,0,0
1972,Papua New Guinea,PNG,1,0,0,0,0,0,0
1972,Philippines,PHL,3,435,465000,678,27000,492678,48000
1972,Tuvalu,TUV,1,6,700,0,0,700,0
1972,United States,USA,2,256,0,0,0,0,2100000
1972,Vanuatu,VUT,3,4,0,0,0,0,0
1973,Bangladesh,BGD,1,1000,0,0,0,0,0
1973,Fiji,FJI,2,59,6150,0,0,6150,0
1973,Hong Kong (China),HKG,1,1,238,38,0,276,0
1973,Indonesia,IDN,1,1650,0,0,0,0,0
1973,Jamaica,JAM,1,6,2500,10,0,2510,1700
1973,Philippines,PHL,3,346,3400000,24,45000,3445024,7000
1973,Tonga,TON,1,3,700,0,200,900,500
1973,Viet Nam,VNM,1,100,150000,0,0,150000,0
1974,Australia,AUS,2,76,45000,640,0,45640,1096717
1974,Bangladesh,BGD,2,2500,0,0,0,0,0
1974,Belize,BLZ,1,0,70000,0,0,70000,4000
1974,Honduras,HND,1,8000,600000,0,0,600000,540000
1974,Hong Kong (China),HKG,2,1,2400,0,0,2400,0
1974,India,IND,2,20,25000,100,0,25100,0
1974,Japan,JPN,2,176,0,50,0,50,0
1974,Mexico,MEX,1,13,0,0,0,0,0
1974,Philippines,PHL,7,203,97095,117,6441,103653,55300
1974,Trinidad and Tobago,TTO,1,2,50000,0,0,50000,5000
1975,Australia,AUS,1,0,0,0,0,0,63861
1975,Fiji,FJI,1,0,23000,0,0,23000,1000
1975,Hong Kong (China),HKG,1,0,671,46,1280,1997,0
1975,India,IND,2,0,0,0,2000,2000,0
1975,Japan,JPN,1,68,123,52,0,175,505000
1975,Madagascar,MDG,1,7,10000,50,0,10050,0
1975,Mauritius,MUS,1,9,826199,59,0,826258,200000
1975,Mexico,MEX,1,29,0,0,0,0,0
1975,Myanmar,MMR,1,200,0,0,0,0,0
1975,New Caledonia,NCL,1,0,0,0,0,0,0
1975,Philippines,PHL,1,39,4518,8,698,5224,2161
1975,Puerto Rico,PRI,1,26,0,0,0,0,0
1975,United States,USA,1,21,0,0,0,0,550000
1976,Australia,AUS,3,0,0,0,0,0,48671
1976,Guam,GUM,1,9,0,0,0,0,120000
1976,Hong Kong (China),HKG,3,38,0,68,2424,2492,0
1976,India,IND,6,270,600000,0,0,600000,266756
1976,Japan,JPN,1,169,325000,107,0,325107,800000
1976,Madagascar,MDG,1,16,500000,26,8850,508876,17000
1976,Mexico,MEX,1,600,175000,1400,100000,276400,100000
1976,New Caledonia,NCL,1,0,0,0,0,0,0
1976,Philippines,PHL,3,387,2704443,17,110,2704570,178426
1977,Bangladesh,BGD,1,13,0,100,0,100,0
1977,Hong Kong (China),HKG,2,1,20,37,71,128,0
1977,India,IND,2,14206,9047400,0,5432400,14479800,498535
1977,Indonesia,IDN,1,1,3000,60,0,3060,0
1977,Japan,JPN,2,32,5000,45,8000,13045,0
1977,Madagascar,MDG,1,10,30000,0,0,30000,350000
1977,Mexico,MEX,1,10,50000,0,0,50000,0
1977,Oman,OMN,1,105,5000,48,0,5048,0
1977,Philippines,PHL,4,104,139922,118,15679,155719,4425
1977,Taiwan (China),TWN,1,61,11000,528,0,11528,250000
1977,Tonga,TON,1,0,10000,5,0,10005,1100
1977,Vanuatu,VUT,1,0,0,0,0,0,0
1977,Viet Nam,VNM,1,0,1000,0,0,1000,0
1978,Australia,AUS,1,5,100,0,0,100,1000000
1978,Belize,BLZ,1,5,6000,0,0,6000,6000
1978,Fiji,FJI,1,0,0,0,0,0,0
1978,Honduras,HND,1,0,0,0,7500,7500,1000
1978,Hong Kong (China),HKG,3,11,2293,185,418,2896,0
1978,India,IND,1,170,0,0,0,0,0
1978,Japan,JPN,1,6,0,100,3000,3100,0
1978,Korea Rep,KOR,1,0,4000,0,0,4000,19000
1978,Madagascar,MDG,1,70,18000,0,0,18000,29000
1978,Mozambique,MOZ,1,4,80000,0,25000,105000,0
1978,Myanmar,MMR,1,0,78000,0,54000,132000,0
1978,Philippines,PHL,9,617,1835169,834,22911,1858914,190084
1978,Sri Lanka,LKA,1,740,1000000,5000,0,1005000,100000
1979,Anguilla,AIA,1,0,0,0,0,0,0
1979,Australia,AUS,1,15,0,0,0,0,31286
1979,Bangladesh,BGD,2,53,0,150,0,150,0
1979,Dominica,DMA,1,40,70000,2100,0,72100,44650
1979,Dominican Rep,DOM,1,1400,1200000,4000,350000,1554000,150000
1979,Fiji,FJI,1,53,20600,300,15000,35900,0
1979,Guadeloupe,GLP,1,0,0,0,0,0,100000
1979,Haiti,HTI,1,8,1110,0,0,1110,0
1979,Hong Kong (China),HKG,2,13,11167,327,1096,12590,10000
1979,India,IND,1,594,1605772,0,0,1605772,12800
1979,Japan,JPN,1,71,0,0,0,0,0
1979,Korea Rep,KOR,1,115,35000,0,0,35000,40000
1979,Martinique,MTQ,1,0,20000,3,0,20003,50000
1979,Mauritius,MUS,2,5,100000,257,5000,105257,175000
1979,Philippines,PHL,5,62,523930,56,61535,585521,26450
1979,Puerto Rico,PRI,1,3,4500,0,0,4500,0
1979,Solomon Is,SLB,1,2,6000,0,0,6000,0
1979,United States,USA,1,31,0,0,0,0,2300000
1979,Vanuatu,VUT,1,0,0,0,0,0,0
1980,Australia,AUS,4,0,0,0,0,0,65529
1980,Bangladesh,BGD,1,11,1000,50,0,1050,0
1980,Barbados,BRB,1,0,0,7,5000,5007,1500
1980,China P Rep,CHN,1,188,0,0,100,100,0
1980,Cuba,CUB,1,3,0,0,0,0,0
1980,Dominica,DMA,1,0,0,0,0,0,0
1980,Dominican Rep,DOM,1,7,0,0,0,0,47000
1980,Fiji,FJI,1,18,28000,250,7000,35250,2256
1980,Grenada,GRD,1,0,0,0,0,0,5300
1980,Haiti,HTI,1,220,330000,0,835000,1165000,400000
1980,Hong Kong (China),HKG,1,2,9,59,0,68,0
1980,India,IND,2,28,0,0,0,0,0
1980,Indonesia,IDN,1,0,0,0,800,800,0
1980,Jamaica,JAM,1,6,30000,9,0,30009,64000
1980,Japan,JPN,1,7,15000,33,2000,17033,0
1980,Korea Rep,KOR,2,165,20000,17,0,20017,7220
1980,Martinique,MTQ,1,0,0,0,0,0,68000
1980,Philippines,PHL,6,212,1326831,55,540079,1866965,118391
1980,Reunion,REU,1,25,7000,0,0,7000,67000
1980,St Lucia,LCA,2,27,70000,0,10000,80000,87990
1980,St Vincent and the Grenad,VCT,1,0,20000,0,500,20500,16300
1980,United States,USA,3,12,0,170,400,570,910000
1980,Viet Nam,VNM,2,308,14987000,384,664500,15651884,0
1981,Bangladesh,BGD,2,1015,2000000,0,25000,2025000,0
1981,Cook Is,COK,1,0,0,0,0,0,0
1981,Fiji,FJI,1,0,4700,0,0,4700,0
1981,India,IND,3,215,121700,0,0,121700,0
1981,Japan,JPN,2,47,60000,100,22500,82600,0
1981,Korea Rep,KOR,1,113,14253,0,0,14253,134000
1981,Madagascar,MDG,1,107,118000,0,0,118000,250000
1981,Mexico,MEX,1,100,0,0,0,0,40000
1981,New Caledonia,NCL,3,4,2000,0,0,2000,200
1981,Philippines,PHL,7,785,1089918,137,11458,1101513,88384
1981,Thailand,THA,1,0,43000,0,0,43000,0
1981,Vanuatu,VUT,2,0,0,0,0,0,1000
1982,Australia,AUS,1,1,0,0,0,0,6864
1982,Cape Verde Is,CPV,1,3,2100,122,0,2222,3000
1982,Cuba,CUB,1,24,105000,0,75000,180000,85000
1982,Honduras,HND,1,130,20000,0,0,20000,101000
1982,India,IND,2,744,5300000,493,0,5300493,745420
1982,Indonesia,IDN,1,2,0,123,0,123,0
1982,Japan,JPN,3,118,3000,252,5000,8252,212000
1982,Korea Rep,KOR,2,68,5000,42,0,5042,30000
1982,Madagascar,MDG,1,92,0,0,70000,70000,250000
1982,Mauritius,MUS,2,0,32500,0,0,32500,973
1982,Mexico,MEX,1,225,50000,0,0,50000,82400
1982,Myanmar,MMR,1,11,36000,0,0,36000,0
1982,Nicaragua,NIC,1,71,52000,0,0,52000,356000
1982,Philippines,PHL,9,563,690172,360,329083,1019615,118605
1982,Solomon Is,SLB,1,0,30000,0,0,30000,0
1982,Tonga,TON,1,6,100000,12,46500,146512,21200
1982,United States,USA,1,3,0,0,500,500,230000
1982,Viet Nam,VNM,1,70,1300000,290,0,1300290,0
1983,Bangladesh,BGD,3,673,5000,150,0,5150,0
1983,China P Rep,CHN,2,112,10000,200,0,10200,0
1983,Comoros,COM,1,33,30000,52,0,30052,23000
1983,Fiji,FJI,2,9,211132,14,0,211146,50851
1983,French Polynesia,PYF,2,7,5000,50,0,5050,37000
1983,Hong Kong (China),HKG,2,22,0,396,2166,2562,12544
1983,India,IND,3,727,1506000,1500,14000,1521500,566000
1983,Japan,JPN,1,44,0,78,0,78,0
1983,Madagascar,MDG,1,42,13560,0,0,13560,25000
1983,Mauritius,MUS,1,1,350,1,0,351,0
1983,Mexico,MEX,1,135,0,0,25000,25000,0
1983,Philippines,PHL,3,126,140542,28,29860,170430,4320
1983,Taiwan (China),TWN,1,82,0,0,0,0,0
1983,United States,USA,1,21,0,0,0,0,3000000
1983,Viet Nam,VNM,2,658,580000,508,601360,1181868,0
1984,Anguilla,AIA,1,0,0,0,0,0,2115
1984,Cape Verde Is,CPV,1,29,5500,0,0,5500,0
1984,China P Rep,CHN,3,13,0,0,0,0,0
1984,Dominica,DMA,1,2,10000,0,0,10000,2000
1984,France,FRA,1,0,0,0,0,0,0
1984,India,IND,3,524,1335000,0,0,1335000,35000
1984,Madagascar,MDG,1,68,100000,215,0,100215,250000
1984,Mauritius,MUS,1,0,0,0,0,0,0
1984,Mexico,MEX,1,4,10000,0,0,10000,0
1984,Mozambique,MOZ,1,109,350000,0,0,350000,75000
1984,Philippines,PHL,4,2679,3210815,2865,1321526,4535206,336490
1984,Reunion,REU,1,0,0,0,0,0,0
1984,South Africa,ZAF,1,64,500000,0,0,500000,92000
1984,Spain,ESP,1,6,60000,30,0,60030,1000000
1984,St Kitts and Nevis,KNA,1,0,0,0,0,0,0
1984,Swaziland,SWZ,1,53,632000,0,500,632500,54152
1984,Viet Nam,VNM,2,155,650416,383,1000,651799,0
1985,Bangladesh,BGD,1,15000,1300000,0,510000,1810000,50000
1985,China P Rep,CHN,1,177,100000,1400,0,101400,0
1985,Comoros,COM,1,2,35000,0,0,35000,5568
1985,Cuba,CUB,1,4,476891,0,22000,498891,0
1985,Fiji,FJI,3,32,122000,0,0,122000,76000
1985,Hong Kong (China),HKG,1,2,600,12,0,612,42
1985,India,IND,1,78,5000,0,0,5000,0
1985,Jamaica,JAM,1,7,0,0,300,300,5200
1985,Japan,JPN,2,49,30000,200,0,30200,99500
1985,Korea Rep,KOR,1,57,0,20,0,20,14000
1985,Mauritius,MUS,1,0,0,0,0,0,0
1985,Philippines,PHL,3,186,1603687,31,256,1603974,83033
1985,Solomon Is,SLB,1,0,650,0,0,650,0
1985,Turks and Caicos Is,TCA,1,0,770,0,0,770,5
1985,United States,USA,4,32,1000000,0,0,1000000,3500000
1985,Vanuatu,VUT,1,9,117500,0,0,117500,173000
1985,Viet Nam,VNM,1,798,225000,257,225000,450257,0
1986,Australia,AUS,1,3,0,12,1000,1012,70000
1986,Bangladesh,BGD,2,65,2600000,100,100000,2700100,0
1986,China P Rep,CHN,3,223,4000000,1656,2500,4004156,1374000
1986,Fiji,FJI,1,1,3000,0,0,3000,20000
1986,Hong Kong (China),HKG,2,5,0,41,0,41,0
1986,India,IND,2,24,3100000,100,200000,3300100,272943
1986,Ireland,IRL,1,11,0,0,0,0,0
1986,Japan,JPN,1,17,2000,64,0,2064,2200000
1986,Korea Rep,KOR,1,33,6623,73,0,6696,10900
1986,Madagascar,MDG,1,99,83885,424,0,84309,150000
1986,Philippines,PHL,6,176,1235949,154,6633,1242736,86460
1986,Solomon Is,SLB,1,101,90000,0,60000,150000,20000
1986,St Lucia,LCA,1,0,0,0,0,0,0
1986,Taiwan (China),TWN,2,65,0,0,0,0,485000
1986,Viet Nam,VNM,1,435,2500000,2502,0,2502502,0
1986,Wallis and Futuna Is,WLF,1,1,4500,0,0,4500,0
1987,Bangladesh,BGD,1,12,0,0,0,0,0
1987,Barbados,BRB,1,0,0,0,230,230,100000
1987,Bermuda,BMU,1,0,0,40,0,40,50000
1987,China P Rep,CHN,3,274,900000,86,25400,925486,120000
1987,Comoros,COM,1,24,0,0,50000,50000,9000
1987,Cook Is,COK,1,5,2000,0,0,2000,25000
1987,Dominican Rep,DOM,1,3,0,0,0,0,23700
1987,Guam,GUM,1,0,0,0,502,502,145
1987,Guinea Bissau,GNB,1,1,0,3,3700,3703,0
1987,India,IND,2,63,80000,0,0,80000,0
1987,Japan,JPN,1,8,65000,10,0,65010,0
1987,Korea Rep,KOR,2,619,56000,0,0,56000,525000
1987,Micronesia Fed States,FSM,1,5,0,3,200,203,6000
1987,Philippines,PHL,5,1094,2911027,1466,325139,3237632,193700
1987,Reunion,REU,1,10,4000,0,0,4000,2000
1987,St Lucia,LCA,1,0,0,0,0,0,0
1987,St Vincent and the Grenad,VCT,1,0,0,8,200,208,5300
1987,Taiwan (China),TWN,1,61,2200,0,0,2200,0
1987,Tuvalu,TUV,1,0,0,0,0,0,0
1987,United States,USA,1,0,0,0,0,0,0
1987,Vanuatu,VUT,1,48,48000,0,0,48000,25000
1987,Viet Nam,VNM,1,101,584800,211,352000,937011,0
1988,Australia,AUS,1,1,0,0,0,0,20417
1988,Bangladesh,BGD,2,1031,8568860,0,2000000,10568860,0
1988,China P Rep,CHN,2,200,186000,1232,0,187232,0
1988,Colombia,COL,1,26,100000,0,0,100000,50000
1988,Costa Rica,CRI,1,28,120000,7500,0,127500,60000
1988,Cuba,CUB,1,0,60000,0,0,60000,0
1988,Haiti,HTI,1,54,870000,0,0,870000,91286
1988,Honduras,HND,1,0,0,12,0,12,0
1988,Hong Kong (China),HKG,1,0,100,4,0,104,0
1988,India,IND,1,74,1900000,0,0,1900000,13000
1988,Jamaica,JAM,1,49,810000,0,0,810000,1000000
1988,Mexico,MEX,2,288,100000,0,25000,125000,76000
1988,Mozambique,MOZ,1,100,4000,0,0,4000,0
1988,New Zealand,NZL,1,6,0,0,0,0,0
1988,Nicaragua,NIC,1,130,300000,278,60000,360278,400000
1988,Panama,PAN,1,30,6732,0,2000,8732,60000
1988,Philippines,PHL,5,788,4430946,238,66321,4497505,403016
1988,St Lucia,LCA,1,45,0,0,0,0,1000000
1988,United States,USA,1,0,0,0,0,0,0
1988,Vanuatu,VUT,2,0,3100,0,3600,6700,0
1988,Venezuela,VEN,1,11,0,0,0,0,0
1988,Viet Nam,VNM,2,157,1320000,0,0,1320000,0
1989,American Samoa,ASM,1,0,0,0,0,0,5000
1989,Antigua and Barbuda,ATG,1,2,7500,0,530,8030,80000
1989,Australia,AUS,2,4,0,0,0,0,107911
1989,Bangladesh,BGD,1,15,0,2000,0,2000,0
1989,Bermuda,BMU,1,0,0,0,0,0,0
1989,Canada,CAN,1,0,0,0,0,0,0
1989,China P Rep,CHN,4,865,8000000,3444,0,8003444,485000
1989,Comoros,COM,1,0,0,0,0,0,5236
1989,Dominica,DMA,1,0,710,0,0,710,20000
1989,Dominican Rep,DOM,1,0,0,0,0,0,0
1989,Guadeloupe,GLP,1,5,0,84,11000,11084,50000
1989,Hong Kong (China),HKG,2,9,528,150,977,1655,67
1989,India,IND,2,93,3700000,0,0,3700000,0
1989,Japan,JPN,2,15,0,0,0,0,0
1989,Korea Rep,KOR,1,109,75145,49,0,75194,176500
1989,Madagascar,MDG,1,46,55346,0,0,55346,0
1989,Martinique,MTQ,1,0,0,0,0,0,0
1989,Mauritius,MUS,1,1,4000,507,0,4507,60000
1989,Montserrat,MSR,1,11,0,40,12000,12040,240000
1989,Netherlands Antilles,ANT,1,11,0,0,0,0,50000
1989,New Caledonia,NCL,1,2,0,0,0,0,0
1989,Philippines,PHL,7,378,1974519,982,161364,2136865,171085
1989,Puerto Rico,PRI,2,0,2000,0,0,2000,0
1989,Reunion,REU,1,10,6200,61,0,6261,50000
1989,Samoa,WSM,1,0,0,0,0,0,15500
1989,St Kitts and Nevis,KNA,1,1,0,0,1300,1300,46000
1989,Taiwan (China),TWN,1,13,0,0,0,0,0
1989,Thailand,THA,1,458,154000,0,45000,199000,452000
1989,United States,USA,4,53,0,0,25000,25000,7500000
1989,Viet Nam,VNM,3,959,5635000,1359,781000,6417359,21000
1989,Virgin Is (US),VIR,1,0,2000,0,8000,10000,21800
1990,Antigua and Barbuda,ATG,1,0,0,0,0,0,0
1990,Australia,AUS,1,0,0,0,0,0,155600
1990,Bahamas,BHS,1,0,0,0,0,0,0
1990,Bangladesh,BGD,1,370,13870,0,0,13870,0
1990,China P Rep,CHN,7,533,5690800,436,210000,5901236,1869000
1990,Cook Is,COK,1,1,0,0,0,0,0
1990,Fiji,FJI,1,0,3000,0,3000,6000,10000
1990,Grenada,GRD,1,0,1000,0,0,1000,0
1990,Guadeloupe,GLP,1,0,0,0,0,0,0
1990,Haiti,HTI,1,0,0,0,0,0,0
1990,India,IND,2,1207,4100000,0,0,4100000,692800
1990,Japan,JPN,1,40,60000,0,0,60000,4000000
1990,Martinique,MTQ,1,8,1500,0,0,1500,0
1990,Mexico,MEX,1,38,0,0,0,0,90700
1990,Montserrat,MSR,1,0,0,0,0,0,0
1990,Niue,NIU,1,0,200,0,0,200,0
1990,Philippines,PHL,5,737,5208275,1288,1110020,6319583,388500
1990,Samoa,WSM,1,8,170000,0,25000,195000,200000
1990,St Kitts and Nevis,KNA,1,0,0,0,0,0,0
1990,Taiwan (China),TWN,2,5,20000,0,0,20000,0
1990,Thailand,THA,1,36,0,0,0,0,50000
1990,Tokelau,TKL,1,0,0,0,102,102,2400
1990,Tonga,TON,1,1,2600,3,500,3103,2500
1990,Trinidad and Tobago,TTO,1,0,1000,0,0,1000,0
1990,Turks and Caicos Is,TCA,1,0,0,0,0,0,0
1990,Tuvalu,TUV,1,0,300,0,400,700,0
1990,Viet Nam,VNM,3,102,500000,108,2000,502108,0
1991,Bangladesh,BGD,1,138866,15000000,138849,300000,15438849,1780000
1991,China P Rep,CHN,3,147,1049130,5374,0,1054504,692890
1991,Hong Kong (China),HKG,1,22,0,182,0,182,10000
1991,India,IND,1,125,25000,0,0,25000,0
1991,Japan,JPN,5,101,90000,777,351,91128,10086500
1991,Korea Rep,KOR,1,72,20750,0,0,20750,310000
1991,Madagascar,MDG,1,36,125000,0,125000,250000,0
1991,Marshall Is,MHL,1,0,0,0,6000,6000,0
1991,Mauritius,MUS,1,0,6000,0,1500,7500,0
1991,Philippines,PHL,6,6083,1494506,3109,74250,1571865,275000
1991,Samoa,WSM,1,13,85000,0,3000,88000,278000
1991,Taiwan (China),TWN,1,33,0,4,0,4,0
1991,Thailand,THA,1,38,1858811,20,35407,1894238,8323
1991,United States,USA,2,20,1200,0,0,1200,1500000
1991,Viet Nam,VNM,2,38,770,22,455905,456697,9500
1992,Bahamas,BHS,1,4,0,0,1700,1700,250000
1992,China P Rep,CHN,2,221,5000000,0,0,5000000,837400
1992,Fiji,FJI,1,1,2000,0,0,2000,1600
1992,Guam,GUM,1,1,0,542,5000,5542,300000
1992,Hong Kong (China),HKG,1,0,0,18,43,61,219700
1992,India,IND,1,25,0,100,0,100,0
1992,Japan,JPN,1,11,0,86,0,86,0
1992,Korea Rep,KOR,1,0,375,0,58,433,0
1992,Lao P Dem Rep,LAO,1,22,268775,102,0,268877,3650
1992,Mexico,MEX,1,3,10000,0,0,10000,3000
1992,Philippines,PHL,3,75,311155,78,1965,313198,0
1992,Taiwan (China),TWN,1,8,0,0,0,0,35000
1992,Thailand,THA,2,3,253652,0,13007,266659,0
1992,Ukraine,UKR,1,0,1000,0,0,1000,1600
1992,United States,USA,3,48,45000,55,250000,295055,31500000
1992,Vanuatu,VUT,2,2,1150,10,0,1160,0
1992,Viet Nam,VNM,2,31,76125,23,3210,79358,18400
1993,Bangladesh,BGD,2,64,7500,500,2000,10000,0
1993,China P Rep,CHN,7,75,8474000,771,0,8474771,1232130
1993,Fiji,FJI,1,21,150000,3,10000,160003,100000
1993,Guinea Bissau,GNB,1,0,1722,0,0,1722,0
1993,Hong Kong (China),HKG,4,7,831,296,59,1186,6920
1993,India,IND,2,186,12000,500,60000,72500,100000
1993,Japan,JPN,2,95,30255,208,0,30463,1750000
1993,Korea Dem P Rep,PRK,1,6,2500,0,0,2500,110000
1993,Macau,MAC,3,0,1200,4,1153,2357,0
1993,Martinique,MTQ,1,2,0,10,3000,3010,0
1993,Mexico,MEX,4,38,54000,0,23000,77000,1670000
1993,Nicaragua,NIC,1,37,123000,0,0,123000,0
1993,Norway,NOR,1,0,0,0,0,0,3000
1993,Pakistan,PAK,1,609,0,0,0,0,0
1993,Papua New Guinea,PNG,1,15,25000,40,15000,40040,1500
1993,Philippines,PHL,5,490,3331639,566,179122,3511327,257442
1993,Reunion,REU,1,14,0,0,0,0,0
1993,Solomon Is,SLB,1,4,88500,0,0,88500,0
1993,Trinidad and Tobago,TTO,1,0,0,0,0,0,57
1993,Tuvalu,TUV,1,0,0,0,150,150,0
1993,United States,USA,3,4,0,60,0,60,0
1993,Vanuatu,VUT,1,4,5000,5,7000,12005,6000
1993,Venezuela,VEN,1,100,0,400,5500,5900,4500
1993,Viet Nam,VNM,2,203,26520,36,10185,36741,65000
1994,Australia,AUS,1,22,0,0,0,0,0
1994,Bangladesh,BGD,2,170,450000,3709,200000,653709,127500
1994,Bhutan,BTN,1,17,65000,0,0,65000,0
1994,China P Rep,CHN,4,1385,23465000,3168,693000,24161168,1947000
1994,Cuba,CUB,1,2,67738,0,42820,110558,101968
1994,India,IND,1,208,428500,0,0,428500,19100
1994,Japan,JPN,2,3,0,7,0,7,6000
1994,Korea Rep,KOR,1,28,0,2,86,88,11
1994,Madagascar,MDG,3,212,500000,51,40000,540051,10200
1994,Mauritius,MUS,1,2,800,0,1500,2300,135400
1994,Mozambique,MOZ,1,240,2000000,2000,500000,2502000,0
1994,Myanmar,MMR,1,17,64970,0,0,64970,10000
1994,Philippines,PHL,10,186,1599548,162,317949,1917659,138413
1994,Russia,RUS,1,0,0,0,0,0,60000
1994,Somalia,SOM,1,30,0,0,0,0,0
1994,St Lucia,LCA,1,4,600,0,150,750,0
1994,Taiwan (China),TWN,5,45,457,131,0,588,457000
1994,Tanzania Uni Rep,TZA,1,4,0,0,2500,2500,0
1994,Thailand,THA,3,19,15000,0,0,15000,20000
1994,United States,USA,1,32,20000,22,0,20022,250000
1994,Viet Nam,VNM,1,30,11000,0,0,11000,45000
1995,Antigua and Barbuda,ATG,1,2,0,165,3537,3702,350000
1995,Australia,AUS,1,7,7000,15,30,7045,98000
1995,Bahamas,BHS,1,0,0,0,0,0,400
1995,Bangladesh,BGD,1,172,250000,0,0,250000,0
1995,Barbados,BRB,1,0,0,0,0,0,0
1995,Canada,CAN,1,2,0,0,0,0,100000
1995,China P Rep,CHN,1,445,0,0,25000,25000,87000
1995,Costa Rica,CRI,1,0,3262,0,4800,8062,6300
1995,Cuba,CUB,2,2,160,3,0,163,2000
1995,Dominica,DMA,2,2,0,1,5000,5001,195000
1995,Guadeloupe,GLP,1,0,0,0,0,0,50000
1995,Honduras,HND,1,18,0,22,0,22,0
1995,India,IND,2,222,12000,0,0,12000,48300
1995,Japan,JPN,1,3,500,0,0,500,9600
1995,Korea Rep,KOR,2,73,2400,160,2600,5160,565000
1995,Lao P Dem Rep,LAO,1,26,0,0,1000000,1000000,0
1995,Martinique,MTQ,1,0,0,0,0,0,160000
1995,Mexico,MEX,4,153,20800,0,43000,63800,2424700
1995,Montserrat,MSR,1,0,0,0,0,0,20000
1995,Netherlands Antilles,ANT,1,2,40000,0,0,40000,1000000
1995,Nicaragua,NIC,1,38,15085,0,0,15085,0
1995,Philippines,PHL,5,1218,2919526,2438,106000,3027964,317100
1995,Puerto Rico,PRI,2,1,98000,0,0,98000,300000
1995,St Kitts and Nevis,KNA,1,0,1800,0,0,1800,197000
1995,Thailand,THA,1,27,0,0,0,0,0
1995,United States,USA,3,38,84000,0,0,84000,5800000
1995,Viet Nam,VNM,1,16,23000,51,0,23051,21200
1995,Virgin Is (UK),VGB,1,0,0,0,0,0,10000
1995,Virgin Is (US),VIR,2,7,0,0,10000,10000,936000
1996,Australia,AUS,1,0,1500,10,250,1760,46700
1996,Bangladesh,BGD,2,549,82600,35791,0,118391,0
1996,Canada,CAN,1,0,0,0,0,0,100
1996,China P Rep,CHN,5,547,15100000,5300,10000,15115300,1920000
1996,Costa Rica,CRI,1,51,500000,0,0,500000,200000
1996,Cuba,CUB,1,0,269995,0,66681,336676,13000
1996,Dominican Rep,DOM,1,24,25000,0,0,25000,0
1996,El Salvador,SLV,1,12,0,0,0,0,10
1996,France,FRA,1,1,0,0,0,0,10
1996,Germany,DEU,1,0,0,0,0,0,500
1996,Guatemala,GTM,1,0,0,0,0,0,500
1996,Haiti,HTI,1,26,0,0,0,0,100
1996,Honduras,HND,2,1,0,0,0,0,1500
1996,India,IND,4,1537,9177100,0,0,9177100,1500300
1996,Ireland,IRL,1,2,0,0,0,0,1000
1996,Jamaica,JAM,1,0,0,0,800,800,3000
1996,Japan,JPN,1,6,5400,74,264,5738,0
1996,Madagascar,MDG,1,9,100000,0,0,100000,0
1996,Malaysia,MYS,1,270,1150,26,3000,4176,52000
1996,Martinique,MTQ,1,0,0,0,0,0,10
1996,Mauritius,MUS,1,3,0,0,0,0,0
1996,Mexico,MEX,3,10,0,80,18500,18580,10
1996,Mozambique,MOZ,1,11,200000,0,0,200000,14500
1996,Nicaragua,NIC,2,44,10724,0,0,10724,10100
1996,Philippines,PHL,1,26,36815,13,0,36828,38000
1996,Puerto Rico,PRI,1,18,57315,0,0,57315,500000
1996,Taiwan (China),TWN,2,65,0,0,0,0,1300000
1996,Thailand,THA,1,9,343386,0,0,343386,150000
1996,United Kingdom,GBR,1,5,12000,0,0,12000,300000
1996,United States,USA,1,39,4000,0,0,4000,3400000
1996,Viet Nam,VNM,4,789,666500,591,0,667091,600020
1996,Virgin Is (UK),VGB,1,0,0,3,0,3,2000
1997,Bangladesh,BGD,2,299,2792738,10063,1000000,3802801,0
1997,Belarus,BLR,1,5,21045,45,300,21390,33000
1997,Cambodia,KHM,1,25,0,0,0,0,10
1997,China P Rep,CHN,3,212,6865000,3699,44000,6912699,3609700
1997,Cook Is,COK,1,19,700,200,0,900,0
1997,Fiji,FJI,1,25,3500,0,0,3500,27000
1997,Guam,GUM,1,0,1400,20,5000,6420,200000
1997,Hong Kong (China),HKG,1,1,200,55,0,255,0
1997,India,IND,1,25,0,0,0,0,0
1997,Japan,JPN,2,7,67000,0,0,67000,100000
1997,Korea Dem P Rep,PRK,1,0,0,0,0,0,10
1997,Madagascar,MDG,2,174,520000,0,80000,600000,50000
1997,Malaysia,MYS,1,2,2115,0,0,2115,1000
1997,Mexico,MEX,2,230,753555,200,50000,803755,447800
1997,Mozambique,MOZ,1,0,0,0,0,0,50
1997,Papua New Guinea,PNG,1,32,0,0,7500,7500,0
1997,Peru,PER,1,518,580000,730,0,580730,12000
1997,Philippines,PHL,3,49,366765,5,0,366770,7500
1997,Taiwan (China),TWN,1,44,0,78,0,78,50000
1997,Thailand,THA,2,198,50000,394,0,50394,44500
1997,Tonga,TON,1,0,0,0,3000,3000,0
1997,Ukraine,UKR,1,11,0,0,0,0,34000
1997,United States,USA,1,0,0,0,0,0,0
1997,Viet Nam,VNM,3,3692,697225,907,383045,1081177,480000
1998,Antigua and Barbuda,ATG,1,2,0,25,2000,2025,100000
1998,Bangladesh,BGD,2,219,229440,504,0,229944,0
1998,Belize,BLZ,1,9,60000,0,0,60000,50
1998,China P Rep,CHN,1,5,0,0,0,0,98000
1998,Costa Rica,CRI,1,8,15000,0,1700,16700,91090
1998,Cuba,CUB,1,6,147000,0,0,147000,2000000
1998,Dominican Rep,DOM,1,347,855000,595,120000,975595,1981500
1998,El Salvador,SLV,1,475,84000,0,0,84000,388100
1998,Guadeloupe,GLP,1,0,0,0,0,0,5000
1998,Guatemala,GTM,1,384,105700,0,0,105700,748000
1998,Haiti,HTI,1,190,12000,29,0,12029,180000
1998,Honduras,HND,1,14600,2100000,12000,0,2112000,3793600
1998,India,IND,2,3121,4600000,893,0,4600893,469000
1998,Japan,JPN,4,40,49000,364,0,49364,3335500
1998,Mexico,MEX,2,11,1660,0,0,1660,1000
1998,Nicaragua,NIC,1,3332,868000,228,0,868228,987700
1998,Panama,PAN,1,3,7500,0,0,7500,50
1998,Philippines,PHL,4,594,7322133,866,0,7322999,235437
1998,Puerto Rico,PRI,1,0,0,0,0,0,1750000
1998,St Kitts and Nevis,KNA,1,5,10000,0,0,10000,400000
1998,Taiwan (China),TWN,2,13,400000,0,0,400000,129000
1998,Tonga,TON,2,0,3571,0,0,3571,0
1998,United States,USA,4,14,22153,6,519,22678,3204950
1998,Vanuatu,VUT,1,0,2400,0,0,2400,0
1998,Viet Nam,VNM,2,326,2481635,92,43010,2524737,108200
1998,Virgin Is (US),VIR,1,0,0,0,0,0,100000
1999,Anguilla,AIA,1,0,150,0,0,150,50
1999,Antigua and Barbuda,ATG,2,2,4500,18,1439,5957,0
1999,Australia,AUS,2,6,4000,0,672,4672,500000
1999,Bahamas,BHS,1,1,0,0,0,0,450000
1999,Bangladesh,BGD,1,0,0,0,0,0,0
1999,China P Rep,CHN,4,245,643800,3612,18100,665512,601800
1999,Colombia,COL,1,2,0,0,0,0,500
1999,Cuba,CUB,1,4,228067,0,26923,254990,0
1999,Dominica,DMA,1,0,400,0,315,715,0
1999,Fiji,FJI,1,12,0,0,1772,1772,3500
1999,Grenada,GRD,1,0,210,0,0,210,5500
1999,Guadeloupe,GLP,1,4,400,49,450,899,0
1999,Hong Kong (China),HKG,1,2,0,493,0,493,0
1999,India,IND,3,10378,13165696,4312,700000,13870008,2990000
1999,Japan,JPN,1,26,20000,438,6900,27338,5000000
1999,Korea Rep,KOR,1,4,0,0,514,514,4000
1999,Martinique,MTQ,1,0,400,0,200,600,0
1999,Mauritius,MUS,1,0,0,1000,0,1000,0
1999,Mexico,MEX,1,9,2000,0,2000,4000,0
1999,New Caledonia,NCL,1,0,0,0,0,0,0
1999,Pakistan,PAK,1,231,315040,155,220745,535940,10936
1999,Philippines,PHL,1,7,37200,22,4711,41933,1800
1999,Puerto Rico,PRI,1,1,0,0,0,0,150000
1999,Russia,RUS,1,12,0,0,0,0,0
1999,St Kitts and Nevis,KNA,1,0,1080,0,100,1180,41400
1999,St Lucia,LCA,1,0,0,0,200,200,0
1999,St Vincent and the Grenad,VCT,1,0,100,0,0,100,0
1999,Tajikistan,TJK,1,0,0,0,1500,1500,200
1999,United States,USA,4,82,3000000,10,0,3000010,7232500
1999,Virgin Is (US),VIR,1,3,0,0,0,0,180000
2000,Australia,AUS,3,1,1350,0,0,1350,150000
2000,Bangladesh,BGD,3,35,0,512,69500,70012,0
2000,Belize,BLZ,1,14,62000,570,0,62570,277460
2000,China P Rep,CHN,4,68,2446000,127,42165,2488292,238453
2000,El Salvador,SLV,1,1,100,0,0,100,0
2000,India,IND,2,0,30000,0,0,30000,0
2000,Japan,JPN,2,13,180900,41,0,180941,1700000
2000,Korea Dem P Rep,PRK,1,46,480000,180,147000,627180,6000000
2000,Korea Rep,KOR,2,33,0,0,711,711,82300
2000,Madagascar,MDG,2,153,1106208,1,0,1106209,9000
2000,Mexico,MEX,1,23,30000,0,0,30000,1000
2000,Mozambique,MOZ,2,18,0,4,300,304,1000
2000,Nicaragua,NIC,1,1,2300,0,0,2300,1000
2000,Philippines,PHL,6,394,6067076,355,120000,6187431,83464
2000,Reunion,REU,1,2,0,0,600,600,0
2000,Russia,RUS,1,9,0,0,0,0,50
2000,Sri Lanka,LKA,1,5,375000,0,0,375000,0
2000,Taiwan (China),TWN,2,103,0,102,2000,2102,285000
2000,Thailand,THA,1,2,41219,0,0,41219,0
2000,Viet Nam,VNM,2,20,0,33,6000,6033,26000
2001,Bahamas,BHS,1,0,0,0,0,0,300000
2001,Bangladesh,BGD,2,205,500,2200,0,2700,0
2001,Belize,BLZ,2,30,20000,0,0,20000,250000
2001,Cayman Islands,CYM,1,0,0,0,0,0,60000
2001,China P Rep,CHN,6,262,17919375,8299,213000,18140674,3551000
2001,Cook Is,COK,1,0,744,0,0,744,0
2001,Costa Rica,CRI,1,0,0,0,0,0,1000
2001,Cuba,CUB,1,5,5900000,12,0,5900012,100000
2001,Dominica,DMA,1,3,175,0,0,175,0
2001,Dominican Rep,DOM,1,3,0,0,0,0,10
2001,Fiji,FJI,1,1,0,0,0,0,0
2001,Guatemala,GTM,1,8,6435,11,0,6446,100
2001,Haiti,HTI,1,0,0,0,0,0,20
2001,Honduras,HND,1,21,61051,0,25270,86321,5000
2001,India,IND,2,78,25000,0,2000,27000,0
2001,Jamaica,JAM,1,1,0,0,200,200,55487
2001,Japan,JPN,2,16,8200,55,0,8255,1300000
2001,Mexico,MEX,5,5,5600,0,800,6400,401000
2001,Nicaragua,NIC,1,16,24866,0,0,24866,1000
2001,Philippines,PHL,4,583,3017245,480,100000,3117725,97361
2001,Taiwan (China),TWN,5,195,650000,339,2000,652339,1047000
2001,Tonga,TON,1,0,16500,0,0,16500,51300
2001,United States,USA,1,41,102000,0,70000,172000,6000000
2001,Vanuatu,VUT,2,2,505,0,295,800,0
2001,Viet Nam,VNM,3,53,177450,89,23100,200639,83200
2002,Bangladesh,BGD,2,80,100000,400,0,100400,0
2002,Barbados,BRB,1,0,0,0,2000,2000,200
2002,Cayman Islands,CYM,2,0,300,0,0,300,1500
2002,China P Rep,CHN,1,25,180000,0,0,180000,0
2002,Cuba,CUB,2,3,323970,0,0,323970,46000
2002,El Salvador,SLV,1,0,500,0,0,500,0
2002,Guam,GUM,2,1,10044,0,5100,15144,130000
2002,Guatemala,GTM,1,2,1500,0,0,1500,100
2002,Haiti,HTI,1,4,250,0,0,250,0
2002,India,IND,2,133,0,50,5000,5050,416
2002,Jamaica,JAM,2,4,1500,0,0,1500,1030
2002,Japan,JPN,2,5,100570,27,0,100597,5000
2002,Korea Dem P Rep,PRK,1,3,7401,0,0,7401,500
2002,Korea Rep,KOR,1,184,88625,0,0,88625,4200000
2002,Madagascar,MDG,3,23,521900,1200,5000,528100,181
2002,Mauritius,MUS,1,3,0,50,1000,1050,50000
2002,Mexico,MEX,3,16,509300,230,0,509530,840000
2002,Micronesia Fed States,FSM,2,47,1300,148,175,1623,500
2002,Nicaragua,NIC,1,2,300,0,0,300,1000
2002,Northern Mariana Is,MNP,1,0,0,0,300,300,0
2002,Oman,OMN,1,7,50,33,0,83,50000
2002,Philippines,PHL,3,102,711000,41,3000,714041,6664
2002,Reunion,REU,1,0,0,300,2800,3100,50000
2002,Russia,RUS,1,6,0,0,0,0,0
2002,Seychelles,SYC,1,0,6800,0,0,6800,0
2002,Solomon Is,SLB,1,0,0,10,1100,1110,0
2002,St Vincent and the Grenad,VCT,1,4,0,0,0,0,11000
2002,Taiwan (China),TWN,1,7,0,0,0,0,0
2002,United States,USA,2,1,13200,0,0,13200,2300000
2003,Bangladesh,BGD,2,51,0,400,0,400,0
2003,Bermuda,BMU,1,4,0,0,0,0,300000
2003,Canada,CAN,2,2,200,0,0,200,110000
2003,China P Rep,CHN,3,58,9120000,1020,68925,9189945,537938
2003,Dominican Rep,DOM,1,8,10000,0,0,10000,0
2003,Fiji,FJI,1,17,30000,0,0,30000,30000
2003,Hong Kong (China),HKG,2,4,3500,33,0,3533,0
2003,India,IND,4,100,140,4060,41000,45200,28000
2003,Japan,JPN,2,21,2230,173,0,2403,105000
2003,Korea Rep,KOR,1,130,65000,0,15000,80000,4500000
2003,Madagascar,MDG,3,89,114641,86,48023,162750,0
2003,Mexico,MEX,2,4,9000,0,0,9000,100000
2003,Micronesia Fed States,FSM,1,0,0,0,1000,1000,0
2003,Mozambique,MOZ,1,11,23000,10,0,23010,0
2003,New Caledonia,NCL,1,2,0,100,1000,1100,40000
2003,Philippines,PHL,6,93,347593,20,83203,430816,35229
2003,Puerto Rico,PRI,1,0,0,0,100,100,0
2003,Russia,RUS,1,0,0,0,0,0,0
2003,Solomon Is,SLB,2,0,275,0,150,425,0
2003,Taiwan (China),TWN,1,3,0,0,0,0,0
2003,United States,USA,2,16,225000,4,0,225004,3386000
2003,Viet Nam,VNM,1,0,0,18,5000,5018,0
2003,Zaire/Congo Dem Rep,COD,1,17,0,2500,20000,22500,0
2003,Zimbabwe,ZWE,1,8,0,0,0,0,0
2004,American Samoa,ASM,1,0,20000,60,3000,23060,150000
2004,Bahamas,BHS,3,12,9000,0,0,9000,1550000
2004,Barbados,BRB,1,1,0,0,880,880,5000
2004,Brazil,BRA,1,4,150000,60,0,150060,350000
2004,Cayman Islands,CYM,2,2,0,0,0,0,3435080
2004,China P Rep,CHN,2,190,8590000,4007,509350,9103357,2195000
2004,Cuba,CUB,2,4,205745,5,41500,247250,1200000
2004,Dominican Rep,DOM,3,15,14250,9,0,14259,297000
2004,Fiji,FJI,1,16,5000,0,0,5000,4000
2004,Grenada,GRD,1,39,60000,0,0,60000,889000
2004,Guam,GUM,2,1,300,0,0,300,1000
2004,Haiti,HTI,2,2757,302926,2620,16548,322094,51000
2004,Indonesia,IDN,1,0,1315,0,0,1315,0
2004,Jamaica,JAM,2,16,350120,6,0,350126,895000
2004,Japan,JPN,8,199,329556,1483,0,331039,15143500
2004,Korea Rep,KOR,3,14,0,0,2922,2922,251000
2004,Madagascar,MDG,2,395,773000,979,258450,1032429,250000
2004,Mexico,MEX,1,20,0,0,0,0,0
2004,Micronesia Fed States,FSM,1,1,6000,8,0,6008,0
2004,Myanmar,MMR,1,236,0,0,25000,25000,688
2004,Niue,NIU,1,1,200,2,500,702,40000
2004,Northern Mariana Is,MNP,1,3,200,0,0,200,0
2004,Philippines,PHL,7,1854,3232763,1311,2700,3236774,138867
2004,Puerto Rico,PRI,2,2,3500,0,0,3500,100000
2004,Russia,RUS,2,9,0,62,0,62,6000
2004,Samoa,WSM,1,1,0,0,0,0,0
2004,St Lucia,LCA,1,0,0,0,0,0,500
2004,St Vincent and the Grenad,VCT,1,0,1000,4,0,1004,5000
2004,Taiwan (China),TWN,5,79,8765,108,0,8873,407710
2004,Thailand,THA,1,1,4000,0,0,4000,0
2004,Tonga,TON,1,0,0,0,0,0,0
2004,Trinidad and Tobago,TTO,1,1,560,0,0,560,1000
2004,Turks and Caicos Is,TCA,1,0,200,0,0,200,0
2004,United States,USA,5,122,5070000,0,0,5070000,53062500
2004,Vanuatu,VUT,1,2,54000,8,0,54008,0
2004,Venezuela,VEN,1,5,1645,5,80,1730,0
2004,Viet Nam,VNM,2,70,500900,5,0,500905,30000
2004,Virgin Is (US),VIR,1,0,0,0,0,0,0
2005,American Samoa,ASM,1,0,0,0,0,0,0
2005,Bahamas,BHS,1,1,1500,0,0,1500,0
2005,Bangladesh,BGD,1,24,0,500,10000,10500,0
2005,Belize,BLZ,2,3,0,0,0,0,0
2005,Canary Is,SPI,1,19,0,0,0,0,375000
2005,China P Rep,CHN,6,323,31393000,8,13000,31406008,6690000
2005,Colombia,COL,1,0,3074,0,0,3074,0
2005,Cook Is,COK,1,0,600,8,0,608,0
2005,Costa Rica,CRI,1,1,1074,0,0,1074,20000
2005,Cuba,CUB,2,20,2600000,0,0,2600000,2100000
2005,Dominican Rep,DOM,1,9,1000,0,0,1000,0
2005,El Salvador,SLV,2,69,72141,0,0,72141,355700
2005,Grenada,GRD,1,1,1650,0,0,1650,0
2005,Guatemala,GTM,1,1513,474928,386,0,475314,988300
2005,Haiti,HTI,5,71,27740,53,185,27978,50500
2005,Honduras,HND,4,53,103869,0,0,103869,115500
2005,Jamaica,JAM,3,6,10396,0,0,10396,34500
2005,Japan,JPN,2,35,270090,144,0,270234,1000000
2005,Korea Rep,KOR,2,10,1100,0,0,1100,5500
2005,Madagascar,MDG,1,78,0,8,7977,7985,0
2005,Mexico,MEX,4,47,2669571,0,300000,2969571,7910000
2005,Morocco,MAR,1,1,0,0,0,0,50
2005,Nicaragua,NIC,2,7,7880,0,5763,13643,0
2005,Philippines,PHL,2,34,20011,0,0,20011,2000
2005,Samoa,WSM,1,9,0,0,0,0,0
2005,St Vincent and the Grenad,VCT,1,0,530,0,0,530,0
2005,Taiwan (China),TWN,4,17,1500,139,0,1639,239000
2005,Thailand,THA,1,10,2000,0,0,2000,20000
2005,Tokelau,TKL,1,0,0,1,25,26,0
2005,Trinidad and Tobago,TTO,1,0,0,0,0,0,0
2005,United States,USA,4,1852,830000,0,0,830000,157530000
2005,Viet Nam,VNM,3,103,361132,28,0,361160,250250
2006,Australia,AUS,3,0,2000,30,7000,9030,1182354
2006,Bangladesh,BGD,3,146,9135,565,2400,12100,0
2006,China P Rep,CHN,6,1483,55223000,1362,2000,55226362,7577000
2006,Cuba,CUB,1,0,260,8,0,268,0
2006,Fiji,FJI,1,0,168,0,0,168,0
2006,Haiti,HTI,1,5,15000,0,0,15000,0
2006,India,IND,1,114,0,300,150000,150300,0
2006,Japan,JPN,1,10,12000,448,0,12448,2500000
2006,Madagascar,MDG,2,4,6112,0,404,6516,0
2006,Mexico,MEX,3,15,270700,0,0,270700,2700
2006,Myanmar,MMR,1,34,60075,31,0,60106,0
2006,Philippines,PHL,10,1805,7819149,2659,0,7821808,330921
2006,Taiwan (China),TWN,2,3,800,0,0,800,0
2006,United States,USA,1,6,140,0,0,140,32860
2006,Viet Nam,VNM,4,387,2943720,1885,350680,3296285,1080000
2007,Australia,AUS,1,2,730,0,90,820,100000
2007,Bahamas,BHS,1,1,7000,0,0,7000,0
2007,Bangladesh,BGD,2,4275,8923259,55282,225,8978766,2300000
2007,Belize,BLZ,1,0,20000,0,0,20000,14847
2007,China P Rep,CHN,3,48,8000000,0,0,8000000,2606343
2007,Cuba,CUB,2,1,192488,0,0,192488,500000
2007,Dominica,DMA,1,2,7500,30,0,7530,20000
2007,Dominican Rep,DOM,3,163,142933,0,0,142933,162700
2007,El Salvador,SLV,1,0,2800,0,0,2800,0
2007,Fiji,FJI,2,1,69,0,0,69,652
2007,Guadeloupe,GLP,1,0,0,0,0,0,300000
2007,Guatemala,GTM,1,0,3905,0,0,3905,0
2007,Haiti,HTI,3,102,114680,141,260,115081,0
2007,Honduras,HND,1,1,19500,0,0,19500,6579
2007,India,IND,1,0,0,0,0,0,0
2007,Iran Islam Rep,IRN,1,12,160000,9,0,160009,0
2007,Jamaica,JAM,2,5,32000,0,1188,33188,300000
2007,Japan,JPN,3,13,40900,94,0,40994,1060000
2007,Korea Dem P Rep,PRK,1,0,0,0,1649,1649,0
2007,Korea Rep,KOR,1,20,0,2,600,602,70000
2007,Madagascar,MDG,3,84,210495,16,12000,222511,240000
2007,Martinique,MTQ,1,1,0,6,0,6,300000
2007,Mauritius,MUS,1,2,0,0,0,0,0
2007,Mexico,MEX,4,20,173000,0,30000,203000,600000
2007,Mozambique,MOZ,1,10,162700,70,0,162770,0
2007,New Zealand,NZL,1,0,300,0,0,300,0
2007,Nicaragua,NIC,1,188,188726,0,0,188726,0
2007,Oman,OMN,1,76,20000,0,0,20000,3900000
2007,Pakistan,PAK,1,242,1650000,0,0,1650000,1620000
2007,Papua New Guinea,PNG,1,172,162140,0,0,162140,0
2007,Philippines,PHL,9,89,1922285,24,0,1922309,10215
2007,Puerto Rico,PRI,1,1,0,0,0,0,0
2007,Reunion,REU,1,2,0,90,0,90,0
2007,St Lucia,LCA,1,1,0,0,0,0,40000
2007,Taiwan (China),TWN,2,18,1000,79,1800,2879,60000
2007,United States,USA,1,7,0,0,0,0,0
2007,Viet Nam,VNM,1,96,637755,150,47525,685430,191000
2007,Zimbabwe,ZWE,1,0,0,0,0,0,1200
2008,Antigua and Barbuda,ATG,1,0,25800,0,0,25800,0
2008,Bahamas,BHS,2,0,3000,0,0,3000,0
2008,Bangladesh,BGD,2,27,0,400,0,400,0
2008,Belize,BLZ,1,7,10000,0,0,10000,0
2008,Cayman Islands,CYM,2,0,0,0,0,0,0
2008,China P Rep,CHN,7,56,1649000,6,0,1649006,1259000
2008,Costa Rica,CRI,1,4,55000,0,0,55000,0
2008,Cuba,CUB,4,7,499445,19,0,499464,3572000
2008,Dominican Rep,DOM,3,13,17000,2,0,17002,0
2008,Fiji,FJI,1,7,0,0,0,0,0
2008,Guatemala,GTM,1,17,0,0,0,0,0
2008,Haiti,HTI,4,698,246160,86,30,246276,0
2008,Honduras,HND,1,0,0,0,0,0,0
2008,Hong Kong (China),HKG,3,2,0,207,0,207,380
2008,Jamaica,JAM,2,13,4000,0,0,4000,66198
2008,Madagascar,MDG,3,105,338248,580,194338,533166,60000
2008,Mexico,MEX,1,2,500000,0,0,500000,75000
2008,Mozambique,MOZ,1,9,165000,13,55000,220013,20000
2008,Myanmar,MMR,1,138366,2400000,20000,0,2420000,4000000
2008,Nicaragua,NIC,1,13,25000,0,0,25000,0
2008,Philippines,PHL,11,819,6846388,946,4645,6851979,441625
2008,Sri Lanka,LKA,1,9,50000,0,0,50000,0
2008,Taiwan (China),TWN,5,54,0,88,0,88,142400
2008,Thailand,THA,2,0,0,0,1000,1000,0
2008,Turks and Caicos Is,TCA,3,4,1500,0,0,1500,500000
2008,United States,USA,5,144,2300400,0,0,2300400,38540000
2008,Viet Nam,VNM,5,254,143830,159,12660,156649,190500
2009,Australia,AUS,1,0,400,0,0,400,0
2009,Bangladesh,BGD,2,197,3947363,7187,0,3954550,270000
2009,Bhutan,BTN,1,12,0,0,0,0,0
2009,Cambodia,KHM,2,19,178000,91,0,178091,0
2009,Canada,CAN,1,0,0,3,0,3,0
2009,China P Rep,CHN,4,33,12000000,62,0,12000062,1752595
2009,El Salvador,SLV,1,275,75000,0,15000,90000,939000
2009,Fiji,FJI,1,2,3845,0,0,3845,13300
2009,Hong Kong (China),HKG,1,0,300,50,0,350,0
2009,India,IND,2,116,5100000,0,0,5100000,300000
2009,Japan,JPN,2,16,7000,119,0,7119,1000000
2009,Lao P Dem Rep,LAO,1,16,128796,91,0,128887,100000
2009,Madagascar,MDG,3,27,122687,10,8102,130799,5000
2009,Mexico,MEX,2,4,112000,0,0,112000,40000
2009,Mozambique,MOZ,1,0,600,3,6500,7103,3000
2009,Nicaragua,NIC,1,0,19897,0,0,19897,0
2009,Philippines,PHL,13,1242,12220696,867,0,12221563,932698
2009,Taiwan (China),TWN,1,630,2307477,46,0,2307523,250000
2009,United States,USA,2,9,0,9,0,9,600000
2009,Viet Nam,VNM,3,306,2867820,1005,108635,2977460,1065200
2010,Antigua and Barbuda,ATG,1,0,5000,0,0,5000,12600
2010,Australia,AUS,1,1,0,0,0,0,0
2010,Bangladesh,BGD,2,11,256910,200,0,257110,0
2010,Barbados,BRB,1,0,2500,0,0,2500,0
2010,Belize,BLZ,1,0,0,0,0,0,0
2010,China P Rep,CHN,4,80,1000000,0,186000,1186000,718785
2010,Cook Is,COK,1,0,2194,8,0,2202,0
2010,Costa Rica,CRI,1,0,0,0,0,0,0
2010,Dominican Rep,DOM,1,0,12000,0,0,12000,0
2010,El Salvador,SLV,3,17,9217,3,2800,12020,20000
2010,Fiji,FJI,1,2,39101,0,0,39101,39427
2010,French Polynesia,PYF,1,1,3400,11,0,3411,11000
2010,Guatemala,GTM,3,174,399988,154,0,400142,650000
2010,Haiti,HTI,1,21,5020,0,0,5020,0
2010,Honduras,HND,2,22,16673,4,7998,24675,90000
2010,Hong Kong (China),HKG,1,1,15000,0,0,15000,0
2010,India,IND,3,168,0,0,500000,500000,0
2010,Jamaica,JAM,1,15,2480,26,0,2506,150000
2010,Korea Dem P Rep,PRK,1,20,40000,0,0,40000,0
2010,Korea Rep,KOR,1,12,41500,0,0,41500,0
2010,Madagascar,MDG,1,120,192000,132,0,192132,0
2010,Mexico,MEX,4,43,555075,0,0,555075,5900000
2010,Myanmar,MMR,1,45,260000,49,0,260049,57000
2010,Nicaragua,NIC,2,5,0,0,0,0,0
2010,Oman,OMN,1,16,0,0,0,0,1000000
2010,Pakistan,PAK,1,23,4000,0,0,4000,80000
2010,Philippines,PHL,3,212,2595412,133,0,2595545,284420
2010,Solomon Is,SLB,1,0,0,0,590,590,0
2010,St Lucia,LCA,1,14,181000,0,0,181000,500
2010,St Vincent and the Grenad,VCT,1,0,6000,0,100,6100,25000
2010,Taiwan (China),TWN,2,34,0,100,0,100,73100
2010,United States,USA,2,9,0,0,0,0,100000
2010,Venezuela,VEN,1,8,0,0,0,0,0
2010,Viet Nam,VNM,3,35,32960,20,1620,34600,44500
2011,Australia,AUS,1,1,7300,0,0,7300,2500000
2011,Bahamas,BHS,1,0,10000,0,0,10000,40000
2011,Canada,CAN,1,1,0,0,0,0,0
2011,China P Rep,CHN,4,26,4649800,0,0,4649800,701585
2011,Dominica,DMA,1,0,144,0,96,240,0
2011,Dominican Rep,DOM,2,7,44000,0,0,44000,30000
2011,Guatemala,GTM,1,5,0,0,0,0,0
2011,Haiti,HTI,2,3,2500,4,540,3044,0
2011,India,IND,1,47,0,0,250000,250000,375625
2011,Japan,JPN,2,81,1300,308,0,1608,2470000
2011,Korea Dem P Rep,PRK,1,10,5612,887,0,6499,0
2011,Madagascar,MDG,1,35,89297,73,25845,115215,0
2011,Martinique,MTQ,1,1,0,0,0,0,0
2011,Mexico,MEX,5,43,550450,0,0,550450,97700
2011,Oman,OMN,1,14,0,200,0,200,0
2011,Papua New Guinea,PNG,1,0,0,0,0,0,0
2011,Philippines,PHL,12,1782,9462385,6291,0,9468676,527238
2011,Puerto Rico,PRI,2,1,1500,0,771,2271,500000
2011,Solomon Is,SLB,1,0,0,0,0,0,0
2011,Thailand,THA,1,18,1000000,0,0,1000000,0
2011,Tonga,TON,1,0,0,0,0,0,3000
2011,United States,USA,2,61,370600,0,0,370600,8050000
2011,Vanuatu,VUT,2,0,32000,0,0,32000,0
2011,Viet Nam,VNM,1,0,0,0,0,0,0
2012,Bahamas,BHS,1,1,0,0,0,0,0
2012,China P Rep,CHN,6,63,10265630,7,48540,10314177,3012000
2012,Cuba,CUB,2,12,45496,0,75000,120496,0
2012,Dominican Rep,DOM,2,5,42515,0,0,42515,0
2012,Fiji,FJI,1,2,8400,0,0,8400,8400
2012,Haiti,HTI,2,88,176500,27,33330,209857,254000
2012,India,IND,1,40,70000,0,0,70000,0
2012,Jamaica,JAM,1,1,215850,0,0,215850,16542
2012,Japan,JPN,3,2,43295,180,0,43475,144400
2012,Korea Dem P Rep,PRK,1,59,10960,1,33500,44461,0
2012,Korea Rep,KOR,3,22,3120,0,0,3120,799000
2012,Madagascar,MDG,3,112,335300,299,0,335599,100000
2012,Malawi,MWI,1,0,6000,0,0,6000,0
2012,Mexico,MEX,2,19,87000,0,0,87000,855000
2012,Mozambique,MOZ,3,33,109945,13,0,109958,0
2012,Philippines,PHL,9,2039,7557756,2724,0,7560480,918137
2012,Puerto Rico,PRI,1,0,0,0,0,0,0
2012,Samoa,WSM,1,12,12703,0,0,12703,133000
2012,South Africa,ZAF,1,0,1350,0,0,1350,0
2012,Sri Lanka,LKA,1,0,0,0,69000,69000,57000
2012,Taiwan (China),TWN,2,14,0,0,0,0,35300
2012,United States,USA,3,64,77000,1,0,77001,52210000
2012,Viet Nam,VNM,3,38,59320,107,279545,338972,342800
2012,Wallis and Futuna Is,WLF,1,0,1250,2,0,1252,0
2013,Australia,AUS,1,6,7500,0,0,7500,2000000
2013,Bangladesh,BGD,1,17,1498579,65,0,1498644,0
2013,China P Rep,CHN,10,212,9591600,150,50000,9641750,10106000
2013,India,IND,3,65,13230000,4,0,13230004,895471
2013,Japan,JPN,4,46,58038,267,0,58305,0
2013,Madagascar,MDG,2,51,44752,127,0,44879,25000
2013,Mexico,MEX,4,210,172000,0,0,172000,5700000
2013,Palau,PLW,1,0,0,0,0,0,0
2013,Philippines,PHL,8,7415,17915713,28858,0,17944571,10136563
2013,Seychelles,SYC,1,0,3000,0,0,3000,9300
2013,Somalia,SOM,1,162,142380,0,0,142380,0
2013,Sri Lanka,LKA,1,7,3478,0,3861,7339,0
2013,Taiwan (China),TWN,3,5,0,54,0,54,61600
2013,Viet Nam,VNM,4,79,1962485,584,375,1963444,1474230
2014,China P Rep,CHN,4,80,10355250,99,0,10355349,7682973
2014,Comoros,COM,1,0,9511,0,0,9511,0
2014,Guatemala,GTM,1,5,100000,0,0,100000,0
2014,India,IND,1,45,920000,0,0,920000,7000000
2014,Japan,JPN,5,37,36465,256,0,36721,400000
2014,Korea Rep,KOR,1,14,0,0,0,0,0
2014,Madagascar,MDG,1,17,0,0,1736,1736,0
2014,Mexico,MEX,6,15,69000,135,0,69135,2539500
2014,Papua New Guinea,PNG,1,0,12346,0,0,12346,0
2014,Philippines,PHL,9,304,9978563,1456,0,9980019,290563
2014,Taiwan (China),TWN,2,0,0,0,0,0,420000
2014,Tonga,TON,1,1,4000,14,0,4014,48000
2014,United States,USA,1,1,834,0,0,834,66000
2014,Vanuatu,VUT,1,12,20000,6,0,20006,0
2014,Viet Nam,VNM,3,38,48075,0,0,48075,10425
