year,"Country iso","Country name",occurrence,"Total deaths",Affected,Injured,Homeless,"Total affected","Total damage ('000 $)"
1965,BOL,Bolivia,1,40,500,0,0,500,100
1965,BRA,Brazil,2,22,230000,0,40000,270000,17000
1965,CHL,Chile,1,600,350000,0,25000,375000,10000
1965,ECU,Ecuador,1,0,50000,0,0,50000,4000
1965,HND,Honduras,1,0,6000,0,0,6000,500
1965,ITA,Italy,1,55,0,0,0,0,0
1965,JPN,Japan,2,142,3000000,0,0,3000000,90000
1965,JOR,Jordan,1,8,500,0,0,500,1000
1965,KOR,"Korea Rep",1,323,321000,245,23214,344459,36500
1965,MYS,Malaysia,1,6,300000,0,0,300000,1000
1965,MEX,Mexico,1,27,0,0,0,0,8000
1965,MAR,Morocco,2,75,47813,0,0,47813,5000
1965,MMR,Myanmar,1,34,0,0,0,0,0
1965,PRY,Paraguay,1,6,25000,0,0,25000,2000
1965,PER,Peru,1,60,0,0,0,0,0
1965,YUG,Yugoslavia,1,3,80000,15000,0,95000,347000
1966,DZA,Algeria,1,57,20000,12,15900,35912,10000
1966,ARG,Argentina,1,62,120000,0,0,120000,30000
1966,BGD,Bangladesh,1,39,500000,0,0,500000,1000
1966,BOL,Bolivia,2,14,6100,0,0,6100,618
1966,BRA,Brazil,3,560,177381,1757,29000,208138,60914
1966,HKG,"Hong Kong (China)",1,65,8561,68,2672,11301,8000
1966,IND,India,1,47,900000,0,0,900000,1400
1966,IDN,Indonesia,1,176,524000,100,0,524100,33000
1966,IRN,"Iran Islam Rep",1,42,0,70,0,70,0
1966,ITA,Italy,1,70,0,0,1300000,1300000,2000000
1966,JOR,Jordan,1,259,3200,92,2500,5792,1400
1966,KOR,"Korea Rep",1,95,131904,85,65630,197619,1900
1966,LAO,"Lao P Dem Rep",1,300,70000,0,2000,72000,15300
1966,MNG,Mongolia,1,57,250000,0,20000,270000,25000
1966,PAN,Panama,1,20,1600,0,1000,2600,1000
1966,PRY,Paraguay,1,0,4890,0,2500,7390,1000
1966,SEN,Senegal,1,0,2000,0,0,2000,50
1966,LKA,"Sri Lanka",1,23,252347,0,100000,352347,5000
1966,THA,Thailand,1,6,200000,200,5000,205200,1000
1966,VNM,"Viet Nam",1,31,125541,0,70361,195902,10000
1967,DZA,Algeria,1,20,30000,0,0,30000,3000
1967,ARG,Argentina,1,56,142000,0,70000,212000,3000
1967,BRA,Brazil,4,820,172836,1307,15400,189543,15300
1967,ECU,Ecuador,1,0,20000,100,400,20500,100
1967,IND,India,1,300,1000000,0,0,1000000,0
1967,IDN,Indonesia,4,160,164000,0,40000,204000,0
1967,IRQ,Iraq,1,0,200000,0,60000,260000,5000
1967,JPN,Japan,2,489,117,34,0,151,20000
1967,MWI,Malawi,1,0,1200,0,0,1200,500
1967,MYS,Malaysia,1,50,125000,0,15000,140000,25600
1967,MEX,Mexico,1,0,8345,0,0,8345,500
1967,MOZ,Mozambique,1,0,50000,0,0,50000,180000
1967,PAK,Pakistan,1,32,150000,0,0,150000,2800
1967,PER,Peru,1,25,40000,300,10000,50300,15000
1967,PRT,Portugal,1,462,1000,100,0,1100,3000
1967,LKA,"Sri Lanka",1,24,47000,0,0,47000,3000
1967,SYR,"Syrian Arab Rep",1,0,40000,0,0,40000,5000
1967,URY,Uruguay,1,8,38063,0,0,38063,39000
1967,VEN,Venezuela,1,0,23000,0,0,23000,4126
1968,BGD,Bangladesh,1,221,14910892,100000,878724,15889616,199400
1968,BOL,Bolivia,1,24,20000,200,6000,26200,3000
1968,ETH,Ethiopia,1,1,10000,0,6000,16000,920
1968,GHA,Ghana,1,0,25000,0,0,25000,74700
1968,IND,India,4,6452,8500000,0,0,8500000,94200
1968,IDN,Indonesia,1,12,150000,0,0,150000,7831
1968,IRN,"Iran Islam Rep",1,30,0,0,0,0,0
1968,IRQ,Iraq,1,0,150000,0,0,150000,3000
1968,ITA,Italy,1,72,0,0,3000,3000,0
1968,KEN,Kenya,1,0,0,0,0,0,50
1968,LAO,"Lao P Dem Rep",1,2,9000,0,600,9600,1280
1968,NPL,Nepal,1,276,1000,0,0,1000,300
1968,NIC,Nicaragua,1,0,1300,0,260,1560,1500
1968,PHL,Philippines,1,29,0,0,0,0,0
1968,ZAF,"South Africa",1,0,0,0,0,0,30000
1968,TZA,"Tanzania Uni Rep",1,40,57000,0,0,57000,1000
1968,TUR,Turkey,1,147,0,0,0,0,0
1969,DZA,Algeria,1,76,200000,237,0,200237,10000
1969,BRA,Brazil,1,316,17700,3221,17384,38305,5770
1969,CHN,"China P Rep",1,0,0,0,0,0,0
1969,COL,Colombia,1,0,70000,0,0,70000,500
1969,CRI,"Costa Rica",1,7,4580,23,0,4603,4000
1969,HKG,"Hong Kong (China)",1,0,2000,0,0,2000,0
1969,IRN,"Iran Islam Rep",1,20,0,0,0,0,0
1969,KOR,"Korea Rep",1,408,227264,409,0,227673,22400
1969,LAO,"Lao P Dem Rep",1,0,0,0,0,0,0
1969,MWI,Malawi,1,0,2300,0,0,2300,200
1969,LKA,"Sri Lanka",1,62,1000000,0,0,1000000,8500
1969,SUR,Suriname,1,0,4600,0,0,4600,50
1969,TUN,Tunisia,1,540,271269,0,0,271269,100000
1969,USA,"United States",1,115,0,0,0,0,400000
1970,ARG,Argentina,1,36,0,0,0,0,25000
1970,BGD,Bangladesh,1,0,10000000,0,0,10000000,25000
1970,BRB,Barbados,1,3,200,10,0,210,500
1970,BEN,Benin,1,0,0,0,0,0,200
1970,BRA,Brazil,1,172,104371,0,0,104371,46000
1970,COL,Colombia,3,407,5004000,0,105000,5109000,138850
1970,CRI,"Costa Rica",2,24,15200,40,0,15240,30000
1970,ECU,Ecuador,2,20,150600,0,0,150600,520
1970,HKG,"Hong Kong (China)",2,0,1070,0,368,1438,0
1970,HUN,Hungary,1,300,0,0,0,0,85000
1970,IND,India,2,1027,10000000,1000,350000,10351000,101200
1970,IDN,Indonesia,1,82,0,0,0,0,0
1970,ITA,Italy,1,37,1300000,0,1650,1301650,268300
1970,KOR,"Korea Rep",1,28,7000,0,0,7000,0
1970,MYS,Malaysia,1,61,243000,0,0,243000,37000
1970,MEX,Mexico,1,35,0,0,0,0,0
1970,MAR,Morocco,1,11,266441,3,0,266444,30000
1970,MMR,Myanmar,1,90,0,0,0,0,0
1970,NPL,Nepal,1,350,20000,0,0,20000,0
1970,PAN,Panama,2,48,43845,500,0,44345,15000
1970,PER,Peru,1,3,131000,50,5000,136050,5200
1970,PRI,"Puerto Rico",1,60,0,0,0,0,0
1970,ROU,Romania,1,215,238755,0,0,238755,500000
1970,VNM,"Viet Nam",1,237,204000,0,0,204000,0
1971,AUS,Australia,1,27,0,0,0,0,20000
1971,BEL,Belgium,1,0,600,0,0,600,0
1971,BRA,Brazil,2,239,11000,2000,0,13000,5200
1971,COL,Colombia,2,51,0,0,0,0,0
1971,ECU,Ecuador,1,0,2400,0,0,2400,50
1971,GUY,Guyana,1,0,21000,0,0,21000,200
1971,IND,India,3,1323,165000,0,0,165000,530000
1971,LAO,"Lao P Dem Rep",1,14,100000,0,15000,115000,200
1971,MOZ,Mozambique,1,500,500000,0,0,500000,0
1971,PRY,Paraguay,1,0,27000,0,0,27000,50
1971,PER,Peru,1,250,330000,0,0,330000,600
1972,AFG,Afghanistan,1,150,250000,0,0,250000,0
1972,BGD,Bangladesh,1,50,0,0,0,0,0
1972,BWA,Botswana,1,0,1000,0,0,1000,50
1972,HTI,Haiti,1,78,40000,0,0,40000,959
1972,HKG,"Hong Kong (China)",2,138,8261,56,13855,22172,0
1972,JPN,Japan,1,458,0,0,0,0,0
1972,KOR,"Korea Rep",2,747,801500,839,326000,1128339,73434
1972,MEX,Mexico,1,37,100000,70,0,100070,0
1972,PAN,Panama,1,0,300,0,0,300,50
1972,PHL,Philippines,1,653,2400000,0,370647,2770647,220000
1972,ESP,Spain,1,0,0,0,0,0,20000
1972,USA,"United States",1,237,3000,0,0,3000,120000
1972,YMD,"Yemen P Dem Rep",1,0,0,0,0,0,0
1973,DZA,Algeria,1,21,85000,0,61000,146000,10000
1973,AUS,Australia,1,12,11000,0,1000,12000,71000
1973,BGD,Bangladesh,2,427,0,0,0,0,0
1973,BRA,Brazil,1,20,0,0,0,0,16000
1973,CAF,"Central African Rep",1,0,13000,0,0,13000,0
1973,COL,Colombia,1,9,5000,172,0,5172,0
1973,ECU,Ecuador,1,0,0,0,30000,30000,0
1973,GTM,Guatemala,1,5,1000,0,0,1000,2500
1973,MEX,Mexico,2,130,150000,27,0,150027,100000
1973,PAK,Pakistan,1,474,4800000,0,0,4800000,661500
1973,PAN,Panama,1,7,4000,0,0,4000,0
1973,PHL,Philippines,1,3,5000,0,0,5000,493
1973,ESP,Spain,1,500,0,0,0,0,400000
1973,TUN,Tunisia,2,111,44240,0,0,44240,5000
1973,USA,"United States",2,56,0,0,0,0,500000
1973,YMN,"Yemen Arab Rep",1,60,0,612,2250,2862,0
1974,DZA,Algeria,1,11,20000,0,0,20000,30000
1974,AUS,Australia,1,14,0,0,0,0,5972
1974,BGD,Bangladesh,1,28700,36000000,0,2000000,38000000,579200
1974,BOL,Bolivia,1,31,18000,0,0,18000,10500
1974,BRA,Brazil,1,205,325000,0,0,325000,121000
1974,CAN,Canada,2,0,0,0,0,0,89500
1974,CHL,Chile,1,32,40000,0,0,40000,10000
1974,IND,India,2,260,0,0,0,0,0
1974,MMR,Myanmar,1,0,1400000,0,0,1400000,0
1974,NER,Niger,1,0,16000,0,0,16000,1000
1974,PHL,Philippines,2,94,1201823,0,0,1201823,17800
1974,RWA,Rwanda,1,0,1900000,0,0,1900000,0
1974,ZAF,"South Africa",1,26,0,0,0,0,0
1974,SYR,"Syrian Arab Rep",1,0,130000,0,75000,205000,39000
1974,TZA,"Tanzania Uni Rep",1,25,50000,0,18000,68000,3000
1974,TUR,Turkey,1,33,0,0,0,0,0
1975,AUS,Australia,1,0,0,0,0,0,54684
1975,BRA,Brazil,1,118,748000,0,80000,828000,254900
1975,EGY,Egypt,1,15,0,0,0,0,0
1975,GRD,Grenada,1,0,0,0,0,0,4700
1975,HKG,"Hong Kong (China)",3,3,3106,0,150,3256,0
1975,IND,India,1,350,27000000,0,7000000,34000000,714259
1975,KEN,Kenya,1,0,16000,0,0,16000,0
1975,MAR,Morocco,1,10,12000,0,0,12000,0
1975,MOZ,Mozambique,2,1,75000,0,0,75000,0
1975,PHL,Philippines,1,0,99,0,0,99,0
1975,ROU,Romania,1,60,1000000,0,0,1000000,50000
1975,SDN,Sudan,1,0,145000,0,0,145000,0
1975,THA,Thailand,1,239,3000000,93,0,3000093,45000
1975,YMN,"Yemen Arab Rep",1,52,50000,0,0,50000,12700
1976,AFG,Afghanistan,1,51,80000,0,0,80000,0
1976,AUS,Australia,1,0,10000,0,0,10000,0
1976,BGD,Bangladesh,1,168,4000000,0,0,4000000,0
1976,CAN,Canada,1,0,0,0,0,0,20000
1976,COL,Colombia,1,47,0,0,0,0,0
1976,ETH,Ethiopia,1,0,50000,0,20000,70000,0
1976,HND,Honduras,1,20,15000,0,0,15000,0
1976,HKG,"Hong Kong (China)",1,0,200,0,0,200,0
1976,IDN,Indonesia,1,163,20000,20,0,20020,0
1976,JPN,Japan,1,0,0,0,0,0,40000
1976,MMR,Myanmar,1,0,0,0,200000,200000,0
1976,NZL,"New Zealand",1,0,129,0,0,129,0
1976,NIC,Nicaragua,1,16,8000,0,0,8000,0
1976,PAK,Pakistan,1,338,5566000,0,0,5566000,505000
1976,PHL,Philippines,2,18,15878,0,0,15878,1553
1976,USA,"United States",1,139,0,0,0,0,41000
1977,ARG,Argentina,1,0,2500,0,0,2500,0
1977,AUS,Australia,1,0,0,0,0,0,17686
1977,BGD,Bangladesh,2,13,213650,0,0,213650,0
1977,BOL,Bolivia,1,10,70000,0,20000,90000,10000
1977,BRA,Brazil,3,62,81000,0,50000,131000,0
1977,BFA,"Burkina Faso",1,0,0,0,900,900,0
1977,CUB,Cuba,1,7,18000,0,0,18000,0
1977,DJI,Djibouti,1,0,85000,0,6000,91000,2500
1977,ETH,Ethiopia,1,7,16000,0,0,16000,0
1977,FRA,France,1,26,25000,0,0,25000,0
1977,GRC,Greece,1,27,1600,0,0,1600,28000
1977,HKG,"Hong Kong (China)",1,0,37,0,60,97,0
1977,IND,India,2,560,1045000,0,0,1045000,0
1977,IDN,Indonesia,3,22,290000,0,0,290000,0
1977,ITA,Italy,2,23,1000,0,0,1000,194000
1977,JPN,Japan,1,5,0,0,0,0,12000
1977,KEN,Kenya,1,100,20000,0,0,20000,10000
1977,KOR,"Korea Rep",2,315,75000,1000,0,76000,33000
1977,MAR,Morocco,1,0,0,0,38000,38000,0
1977,MOZ,Mozambique,1,300,400000,0,40000,440000,55500
1977,MMR,Myanmar,1,3,3000,0,0,3000,0
1977,NZL,"New Zealand",1,0,120,0,0,120,0
1977,PAK,Pakistan,1,848,777000,0,245000,1022000,0
1977,PER,Peru,2,21,640,0,300,940,1000
1977,PHL,Philippines,3,24,7299,0,0,7299,1913
1977,POL,Poland,1,0,1000,0,0,1000,0
1977,SOM,Somalia,1,0,40000,0,0,40000,0
1977,ZAF,"South Africa",1,4,1000,0,0,1000,0
1977,VCT,"St Vincent and the Grenad",1,0,0,0,0,0,0
1977,SWE,Sweden,1,0,0,0,0,0,170000
1977,CHE,Switzerland,1,0,0,0,0,0,0
1977,TWN,"Taiwan (China)",2,45,20000,6000,0,26000,1000
1977,GBR,"United Kingdom",1,6,0,0,0,0,1000
1977,USA,"United States",3,140,2700,0,0,2700,200000
1978,AFG,Afghanistan,1,120,264044,140,7500,271684,52000
1978,ARG,Argentina,1,0,1600,0,0,1600,0
1978,AUS,Australia,2,7,0,0,0,0,20710
1978,BGD,Bangladesh,1,17,400000,0,0,400000,0
1978,BOL,Bolivia,2,40,163000,0,15000,178000,0
1978,BRA,Brazil,1,26,1000,0,0,1000,0
1978,CHL,Chile,1,4,6000,0,0,6000,0
1978,DJI,Djibouti,1,0,100000,0,6000,106000,0
1978,ETH,Ethiopia,1,9,1000,0,0,1000,0
1978,FRA,France,1,3,1000,0,0,1000,0
1978,DFR,"Germany Fed Rep",1,2,0,0,0,0,330000
1978,HKG,"Hong Kong (China)",1,0,300,0,0,300,0
1978,IND,India,2,4610,32000000,0,0,32000000,166000
1978,IDN,Indonesia,4,70,266600,0,15000,281600,0
1978,JPN,Japan,1,8,15000,0,0,15000,0
1978,KOR,"Korea Rep",1,27,2000,0,0,2000,400
1978,LAO,"Lao P Dem Rep",1,31,459000,0,0,459000,0
1978,MYS,Malaysia,1,0,3000,0,0,3000,0
1978,MEX,Mexico,1,6,7000,0,0,7000,24300
1978,MOZ,Mozambique,1,40,200000,0,0,200000,63000
1978,NPL,Nepal,1,130,27000,48,700,27748,513
1978,NZL,"New Zealand",3,0,2726,0,0,2726,0
1978,PAK,Pakistan,1,393,2236000,0,10000,2246000,0
1978,PAN,Panama,1,19,2000,0,0,2000,0
1978,PER,Peru,1,2,17000,0,5000,22000,2000
1978,PHL,Philippines,2,53,2500,0,0,2500,0
1978,SEN,Senegal,1,0,0,0,0,0,2000
1978,ZAF,"South Africa",1,26,0,0,0,0,0
1978,ESP,Spain,1,2,0,0,0,0,25000
1978,LKA,"Sri Lanka",2,10,2000,0,0,2000,0
1978,SDN,Sudan,1,34,100000,0,0,100000,25000
1978,TZA,"Tanzania Uni Rep",1,0,9000,0,0,9000,0
1978,THA,Thailand,2,96,2028000,400,0,2028400,400000
1978,USA,"United States",1,27,0,0,0,0,0
1978,VNM,"Viet Nam",1,74,4000000,0,79000,4079000,0
1978,ZMB,Zambia,1,11,30000,900,0,30900,200
1979,DZA,Algeria,1,0,30000,0,0,30000,0
1979,ARG,Argentina,1,0,20000,0,0,20000,0
1979,BLZ,Belize,1,0,17000,0,0,17000,0
1979,BRA,Brazil,1,300,1500000,0,0,1500000,0
1979,CAN,Canada,1,0,0,0,0,0,19000
1979,COL,Colombia,1,62,100000,0,2000,102000,0
1979,DOM,"Dominican Rep",1,32,1000,0,0,1000,0
1979,EGY,Egypt,1,50,66000,0,0,66000,14000
1979,GRC,Greece,1,15,0,0,0,0,0
1979,HND,Honduras,1,1,40000,0,0,40000,13000
1979,IND,India,4,253,28000000,0,10000,28010000,100000
1979,IDN,Indonesia,3,164,30500,350,4000,34850,3200
1979,JAM,Jamaica,2,44,200000,0,50000,250000,0
1979,JPN,Japan,1,23,28000,50,0,28050,0
1979,MWI,Malawi,1,0,20000,0,0,20000,0
1979,MEX,Mexico,1,0,60000,0,0,60000,0
1979,MAR,Morocco,1,16,5560,0,732,6292,0
1979,MMR,Myanmar,1,0,10000,0,0,10000,0
1979,NIC,Nicaragua,1,0,30000,0,0,30000,0
1979,PAK,Pakistan,1,13,3200,0,0,3200,0
1979,PRY,Paraguay,1,0,120000,0,70000,190000,0
1979,PHL,Philippines,1,0,16000,0,0,16000,6983
1979,PRT,Portugal,2,23,35000,220,10000,45220,32100
1979,ESP,Spain,1,20,0,50,0,50,0
1979,TZA,"Tanzania Uni Rep",1,0,90000,0,0,90000,0
1979,TUN,Tunisia,1,0,750,0,0,750,0
1979,YUG,Yugoslavia,1,22,12000,0,0,12000,0
1980,AFG,Afghanistan,1,0,30000,0,0,30000,0
1980,ARG,Argentina,2,41,40000,0,0,40000,0
1980,AUT,Austria,1,0,0,0,0,0,0
1980,BGD,Bangladesh,1,655,10000000,0,0,10000000,150000
1980,BOL,Bolivia,1,0,15000,0,0,15000,0
1980,BRA,Brazil,2,67,271000,0,0,271000,0
1980,CHN,"China P Rep",4,6303,80000,27100,0,107100,160000
1980,COL,Colombia,1,40,0,50,0,50,0
1980,CRI,"Costa Rica",1,1,1350,0,0,1350,0
1980,FRA,France,1,6,300,13,0,313,0
1980,IND,India,5,2411,32051000,23,0,32051023,320000
1980,IDN,Indonesia,1,153,2946,0,0,2946,3400
1980,IRN,"Iran Islam Rep",2,256,800100,0,150000,950100,0
1980,JPN,Japan,1,20,0,0,0,0,0
1980,MEX,Mexico,2,104,100000,0,0,100000,87000
1980,NZL,"New Zealand",2,0,2900,0,0,2900,0
1980,NIC,Nicaragua,1,0,40000,0,0,40000,0
1980,PAK,Pakistan,1,75,86200,0,0,86200,0
1980,PER,Peru,1,70,36000,0,0,36000,0
1980,PHL,Philippines,1,2,25980,0,0,25980,0
1980,POL,Poland,1,0,4500,0,0,4500,0
1980,THA,Thailand,1,57,630000,0,0,630000,59700
1980,TUR,Turkey,1,75,60000,0,0,60000,15000
1980,USA,"United States",3,36,111000,0,6000,117000,350000
1980,VNM,"Viet Nam",1,94,628000,0,0,628000,0
1981,DZA,Algeria,1,43,0,50,0,50,0
1981,AUS,Australia,3,2,0,0,0,0,199515
1981,BRA,Brazil,2,97,52000,300,0,52300,0
1981,CHN,"China P Rep",5,2315,2954000,33140,200000,3187140,2300000
1981,COL,Colombia,1,150,0,0,0,0,5000
1981,DJI,Djibouti,1,25,102000,0,0,102000,0
1981,DOM,"Dominican Rep",1,20,150000,0,0,150000,0
1981,ETH,Ethiopia,1,0,20000,0,0,20000,0
1981,FRA,France,1,0,0,0,0,0,0
1981,GIN,Guinea,1,0,5000,0,0,5000,0
1981,HND,Honduras,1,0,0,0,0,0,0
1981,IND,India,1,553,16000000,0,0,16000000,250000
1981,IDN,Indonesia,3,509,346000,0,6000,352000,2200
1981,IRN,"Iran Islam Rep",1,58,100,0,0,100,0
1981,LAO,"Lao P Dem Rep",1,0,0,0,0,0,0
1981,MOZ,Mozambique,1,0,500000,0,0,500000,0
1981,NPL,Nepal,2,750,10000,0,0,10000,0
1981,NZL,"New Zealand",1,0,2250,0,0,2250,0
1981,PAK,Pakistan,1,82,0,0,0,0,0
1981,PER,Peru,1,70,0,0,5000,5000,6000
1981,PHL,Philippines,3,353,307500,122,0,307622,27000
1981,PRT,Portugal,1,30,900,0,0,900,0
1981,SOM,Somalia,1,5,30000,0,0,30000,0
1981,ZAF,"South Africa",1,104,0,0,185,185,1000
1981,SUN,"Soviet Union",1,0,0,0,2000,2000,0
1981,LKA,"Sri Lanka",1,7,20000,0,0,20000,0
1981,TUR,Turkey,1,10,0,0,0,0,0
1981,USA,"United States",1,30,0,0,0,0,0
1981,YMD,"Yemen P Dem Rep",2,0,15000,0,0,15000,32200
1981,YUG,Yugoslavia,1,70,0,0,0,0,0
1982,DZA,Algeria,1,37,8500,14,0,8514,0
1982,ARG,Argentina,1,0,50000,0,0,50000,0
1982,AUT,Austria,1,0,0,0,0,0,0
1982,BGD,Bangladesh,1,0,283000,0,25000,308000,0
1982,BEN,Benin,1,0,500000,0,80000,580000,0
1982,BOL,Bolivia,1,0,30000,0,0,30000,400000
1982,CHL,Chile,1,0,8000,0,0,8000,0
1982,CHN,"China P Rep",4,447,601500,4643,210000,816143,0
1982,COL,Colombia,1,90,0,0,0,0,0
1982,ECU,Ecuador,1,307,700000,0,0,700000,232100
1982,SLV,"El Salvador",1,500,50000,18000,0,68000,280000
1982,GTM,Guatemala,1,620,20000,256,0,20256,100000
1982,HKG,"Hong Kong (China)",1,1,184,0,0,184,0
1982,IND,India,2,932,33500000,0,0,33500000,700000
1982,IDN,Indonesia,3,3,39000,0,0,39000,0
1982,JPN,Japan,1,345,27000,347,0,27347,32000
1982,KEN,Kenya,1,75,3000,0,0,3000,0
1982,MWI,Malawi,1,0,6000,0,0,6000,0
1982,MEX,Mexico,2,25,5000,200,0,5200,114600
1982,MNG,Mongolia,1,0,0,0,0,0,0
1982,NPL,Nepal,1,92,0,0,0,0,0
1982,PAK,Pakistan,1,68,10000,0,0,10000,0
1982,PRY,Paraguay,1,0,85000,0,0,85000,0
1982,PER,Peru,2,332,50000,0,5000,55000,0
1982,PHL,Philippines,4,33,200853,232,0,201085,60
1982,POL,Poland,1,0,15000,0,1824,16824,53000
1982,SUN,"Soviet Union",2,0,0,0,586,586,0
1982,ESP,Spain,2,77,225000,1600,0,226600,930000
1982,LKA,"Sri Lanka",2,54,130000,0,0,130000,1000
1982,TZA,"Tanzania Uni Rep",1,0,40000,0,0,40000,0
1982,TUN,Tunisia,1,117,30000,0,0,30000,90000
1982,USA,"United States",2,11,0,0,0,0,33900
1982,YMD,"Yemen P Dem Rep",1,482,300000,0,50000,350000,975000
1983,AIA,Anguilla,1,0,0,0,0,0,0
1983,ARG,Argentina,2,0,5830000,0,250000,6080000,1800000
1983,AUT,Austria,1,0,0,0,0,0,0
1983,BGD,Bangladesh,4,245,7060000,0,100000,7160000,0
1983,BOL,Bolivia,1,250,50000,0,0,50000,48400
1983,BRA,Brazil,2,143,3330000,300,8000,3338300,350000
1983,CAN,Canada,1,0,0,0,0,0,58000
1983,CHN,"China P Rep",1,100,0,0,0,0,0
1983,CUB,Cuba,1,15,164536,39,0,164575,60000
1983,ECU,Ecuador,1,0,200000,0,0,200000,0
1983,FRA,France,3,18,3700,12,0,3712,609500
1983,DFR,"Germany Fed Rep",1,0,0,12,0,12,0
1983,HKG,"Hong Kong (China)",1,1,0,12,600,612,0
1983,IND,India,4,785,250000,0,0,250000,0
1983,IDN,Indonesia,3,20,417480,17,0,417497,7007
1983,LUX,Luxembourg,1,0,0,0,0,0,0
1983,MYS,Malaysia,1,10,15000,0,0,15000,0
1983,NPL,Nepal,1,186,200000,50,0,200050,10000
1983,NZL,"New Zealand",1,0,140,0,0,140,0
1983,PAK,Pakistan,1,39,64300,0,0,64300,0
1983,PNG,"Papua New Guinea",2,56,13000,0,0,13000,11900
1983,PRY,Paraguay,1,76,100000,0,0,100000,82000
1983,PHL,Philippines,1,11,1835,0,0,1835,3
1983,PRT,Portugal,1,19,2000,0,0,2000,95000
1983,SEN,Senegal,1,0,5000,0,0,5000,1406
1983,SUN,"Soviet Union",2,0,1000,0,0,1000,0
1983,ESP,Spain,2,45,501600,0,6000,507600,3900000
1983,LKA,"Sri Lanka",1,3,1000000,0,250000,1250000,0
1983,SDN,Sudan,2,0,102000,0,30000,132000,0
1983,CHE,Switzerland,1,0,0,0,0,0,0
1983,THA,Thailand,1,50,1000000,0,0,1000000,0
1983,USA,"United States",2,10,0,0,0,0,400000
1984,DZA,Algeria,1,54,0,0,1470,1470,0
1984,AUS,Australia,1,36,0,0,0,0,3000
1984,BGD,Bangladesh,1,1200,30000000,0,0,30000000,0
1984,BRB,Barbados,1,0,0,0,100,100,0
1984,BEL,Belgium,1,0,0,0,0,0,0
1984,BOL,Bolivia,1,0,3000,0,0,3000,0
1984,BRA,Brazil,5,263,360000,0,31500,391500,2000000
1984,BFA,"Burkina Faso",1,0,1500,0,0,1500,0
1984,CHN,"China P Rep",2,31,28000,0,0,28000,0
1984,COL,Colombia,1,0,0,0,0,0,0
1984,HND,Honduras,1,0,0,0,0,0,0
1984,IND,India,5,740,19000000,0,0,19000000,90000
1984,IDN,Indonesia,3,26,340200,0,20000,360200,1500
1984,KOR,"Korea Rep",1,166,350984,187,0,351171,165000
1984,LAO,"Lao P Dem Rep",1,14,2000,0,0,2000,0
1984,MRT,Mauritania,1,0,3000,0,0,3000,0
1984,MEX,Mexico,1,0,20000,0,0,20000,0
1984,NPL,Nepal,1,200,0,0,0,0,0
1984,NZL,"New Zealand",1,0,6805,0,0,6805,20000
1984,PAK,Pakistan,1,39,0,0,2000,2000,0
1984,PAN,Panama,1,1,1000,0,0,1000,0
1984,ROU,Romania,1,0,2000,0,0,2000,0
1984,SUN,"Soviet Union",2,0,0,0,0,0,0
1984,LKA,"Sri Lanka",4,51,185000,0,390000,575000,2000
1984,TWN,"Taiwan (China)",1,31,0,15,0,15,0
1984,THA,Thailand,2,17,786140,31,0,786171,403000
1984,TUR,Turkey,1,0,200,0,0,200,0
1984,USA,"United States",3,28,0,0,5500,5500,65000
1984,VNM,"Viet Nam",1,33,38000,0,0,38000,0
1985,DZA,Algeria,1,26,0,0,15000,15000,0
1985,ARG,Argentina,2,37,1150000,0,56000,1206000,1530000
1985,AUS,Australia,1,0,0,0,0,0,5778
1985,AUT,Austria,1,12,0,0,0,0,0
1985,BGD,Bangladesh,2,34,500000,0,0,500000,0
1985,BEN,Benin,1,61,345000,0,130000,475000,4800
1985,BOL,Bolivia,1,0,0,0,475,475,0
1985,BRA,Brazil,2,101,610000,0,2000,612000,200000
1985,BFA,"Burkina Faso",1,0,0,0,572,572,0
1985,TCD,Chad,1,0,0,0,500,500,0
1985,CHN,"China P Rep",7,1216,16000,0,2000,18000,702750
1985,CUB,Cuba,1,0,3000,0,0,3000,0
1985,DOM,"Dominican Rep",1,12,895,0,0,895,0
1985,ETH,Ethiopia,2,9,8000,0,20000,28000,0
1985,HKG,"Hong Kong (China)",2,0,366,0,0,366,0
1985,IND,India,5,1656,10877000,0,450000,11327000,808000
1985,IDN,Indonesia,3,42,4300,0,0,4300,0
1985,ITA,Italy,1,329,0,30,0,30,15000
1985,LSO,Lesotho,1,0,80000,0,0,80000,0
1985,MRT,Mauritania,1,0,6000,0,900,6900,0
1985,MOZ,Mozambique,1,8,500000,0,0,500000,500
1985,NPL,Nepal,1,46,60500,57,2000,62557,0
1985,NZL,"New Zealand",2,4,270,0,0,270,0
1985,NGA,Nigeria,1,0,6000,0,0,6000,8000
1985,PHL,Philippines,2,79,5444,0,0,5444,0
1985,PRI,"Puerto Rico",1,500,0,0,0,0,0
1985,SAU,"Saudi Arabia",1,32,0,0,5000,5000,450000
1985,SEN,Senegal,1,0,3000,0,0,3000,0
1985,SUN,"Soviet Union",2,0,10000,0,0,10000,10000
1985,SWE,Sweden,1,11,0,0,0,0,5800
1985,THA,Thailand,1,18,7640,0,0,7640,3600
1985,USA,"United States",5,12,5550,0,0,5550,12500
1985,VEN,Venezuela,1,38,15000,0,0,15000,0
1985,VNM,"Viet Nam",1,93,2800000,0,0,2800000,0
1986,ARG,Argentina,1,3,144000,0,60000,204000,0
1986,AUS,Australia,1,8,0,0,0,0,64200
1986,BGD,Bangladesh,2,30,100000,0,300000,400000,0
1986,BOL,Bolivia,1,29,260000,0,50000,310000,50000
1986,BRA,Brazil,1,28,1835,0,6500,8335,0
1986,CAN,Canada,1,0,4500,0,0,4500,30000
1986,CHL,Chile,1,23,54118,0,0,54118,17200
1986,CHN,"China P Rep",2,313,9000000,0,800000,9800000,1501210
1986,COL,Colombia,1,13,250000,0,0,250000,0
1986,CUB,Cuba,1,0,7500,0,0,7500,0
1986,FJI,Fiji,1,19,215000,0,0,215000,15400
1986,HTI,Haiti,2,148,130000,660,13200,143860,0
1986,HND,Honduras,1,0,30000,0,0,30000,0
1986,IND,India,3,251,245000,0,150000,395000,376100
1986,IDN,Indonesia,4,175,77000,0,50000,127000,0
1986,IRN,"Iran Islam Rep",2,265,40000,0,0,40000,1591000
1986,ITA,Italy,1,2,0,0,0,0,20000
1986,JAM,Jamaica,1,54,40000,0,0,40000,76000
1986,JPN,Japan,1,14,162000,0,0,162000,0
1986,MDG,Madagascar,1,0,28223,0,0,28223,0
1986,MYS,Malaysia,1,11,25000,0,0,25000,11500
1986,MEX,Mexico,1,20,0,0,0,0,0
1986,NPL,Nepal,2,22,0,0,0,0,0
1986,NZL,"New Zealand",3,1,1830,0,0,1830,19800
1986,PAN,Panama,1,2,3500,0,2500,6000,350
1986,PER,Peru,1,62,200000,0,0,200000,1200
1986,PHL,Philippines,1,3,612,3,0,615,56
1986,LKA,"Sri Lanka",1,43,64485,0,0,64485,934
1986,VCT,"St Vincent and the Grenad",1,0,142,10,0,152,0
1986,TZA,"Tanzania Uni Rep",1,0,0,0,6000,6000,0
1986,THA,Thailand,1,42,27780,21,0,27801,2000
1986,TUN,Tunisia,1,23,0,0,2500,2500,0
1986,USA,"United States",3,13,2000,0,0,2000,25000
1986,URY,Uruguay,1,0,16000,0,2500,18500,0
1986,VNM,"Viet Nam",1,165,0,0,0,0,0
1986,YUG,Yugoslavia,1,0,1000,0,0,1000,0
1987,ARG,Argentina,1,0,12000,0,0,12000,0
1987,BGD,Bangladesh,2,2280,29700000,0,0,29700000,1057500
1987,BEL,Belgium,1,0,0,0,0,0,0
1987,BOL,Bolivia,1,25,20000,0,0,20000,0
1987,BRA,Brazil,2,107,10500,0,0,10500,62000
1987,CAN,Canada,2,1,0,0,0,0,185000
1987,CHL,Chile,2,127,116364,0,81000,197364,177000
1987,CHN,"China P Rep",4,219,940000,529,0,940529,0
1987,COL,Colombia,1,21,800,50,0,850,0
1987,CSK,Czechoslovakia,1,0,0,0,0,0,1000
1987,ECU,Ecuador,1,0,10000,0,0,10000,0
1987,FRA,France,1,23,0,0,0,0,0
1987,GTM,Guatemala,1,84,6500,15,0,6515,0
1987,HTI,Haiti,4,33,8760,150,0,8910,0
1987,HKG,"Hong Kong (China)",2,0,1000,0,0,1000,0
1987,IND,India,4,1314,18300000,0,0,18300000,545000
1987,IDN,Indonesia,5,201,28000,84,800,28884,65700
1987,IRN,"Iran Islam Rep",6,865,0,0,0,0,0
1987,IRL,Ireland,1,0,0,0,0,0,0
1987,ITA,Italy,1,0,0,0,0,0,70000
1987,JAM,Jamaica,1,9,26000,0,0,26000,31000
1987,JOR,Jordan,1,9,0,29,0,29,0
1987,PRK,"Korea Dem P Rep",2,315,20000,71,0,20071,0
1987,KOR,"Korea Rep",1,50,0,0,154000,154000,22000
1987,LBN,Lebanon,1,0,1500,0,0,1500,10000
1987,LSO,Lesotho,1,18,100000,0,0,100000,0
1987,MYS,Malaysia,1,3,2576,0,0,2576,0
1987,MDV,Maldives,1,0,300,0,0,300,6000
1987,MEX,Mexico,2,16,0,12,200,212,0
1987,NPL,Nepal,1,188,351000,0,0,351000,727500
1987,NZL,"New Zealand",1,0,700,0,0,700,0
1987,PER,Peru,2,173,27500,519,500,28519,0
1987,POL,Poland,1,0,0,0,0,0,500000
1987,SOM,Somalia,1,0,0,0,30000,30000,0
1987,ZAF,"South Africa",1,506,65000,0,0,65000,765305
1987,SUN,"Soviet Union",1,110,20000,0,16000,36000,546000
1987,ESP,Spain,1,5,2000,0,0,2000,1283000
1987,KNA,"St Kitts and Nevis",1,0,0,0,0,0,500
1987,VCT,"St Vincent and the Grenad",1,0,1000,0,0,1000,5000
1987,CHE,Switzerland,1,0,0,0,0,0,0
1987,THA,Thailand,1,24,0,0,0,0,7200
1987,VEN,Venezuela,1,40,0,29,0,29,0
1988,AFG,Afghanistan,1,0,161000,0,0,161000,260000
1988,ARG,Argentina,1,25,4600000,0,0,4600000,490000
1988,AUS,Australia,3,16,0,0,0,0,68055
1988,BHS,Bahamas,1,0,0,0,0,0,0
1988,BGD,Bangladesh,2,2440,45000000,0,0,45000000,2137000
1988,BEN,Benin,1,0,68000,0,16000,84000,0
1988,BWA,Botswana,1,8,12000,7,0,12007,0
1988,BRA,Brazil,3,655,3050000,1734,20000,3071734,1030000
1988,BFA,"Burkina Faso",1,16,23324,0,10000,33324,0
1988,CMR,Cameroon,1,2,1000,0,0,1000,0
1988,CAN,Canada,1,2,0,0,0,0,15000
1988,TCD,Chad,1,43,47450,48,0,47498,0
1988,CHN,"China P Rep",8,1243,25525000,705,120000,25645705,1963208
1988,COL,Colombia,1,120,130000,800,0,130800,0
1988,CRI,"Costa Rica",1,7,10000,0,2500,12500,9000
1988,CUB,Cuba,1,23,90000,12,0,90012,0
1988,DOM,"Dominican Rep",1,0,1191150,0,0,1191150,0
1988,SLV,"El Salvador",1,33,39060,0,0,39060,0
1988,ETH,Ethiopia,2,45,47240,0,0,47240,0
1988,FRA,France,1,10,300,0,0,300,500000
1988,GAB,Gabon,1,0,10000,0,0,10000,0
1988,DFR,"Germany Fed Rep",1,6,3500,0,0,3500,0
1988,GLP,Guadeloupe,1,0,0,0,0,0,0
1988,GTM,Guatemala,1,0,6000,0,0,6000,0
1988,HTI,Haiti,4,27,3700,1,200,3901,0
1988,HND,Honduras,2,19,15200,0,925,16125,0
1988,ISL,Iceland,1,0,280,0,0,280,0
1988,IND,India,3,2100,22321000,0,0,22321000,947200
1988,IDN,Indonesia,2,179,100000,0,0,100000,4600
1988,IRN,"Iran Islam Rep",1,90,150000,0,0,150000,150000
1988,JAM,Jamaica,1,0,0,0,0,0,440
1988,JPN,Japan,1,27,0,0,0,0,0
1988,MYS,Malaysia,1,27,60000,0,0,60000,0
1988,MLI,Mali,1,17,0,0,10000,10000,0
1988,NPL,Nepal,1,27,0,0,0,0,0
1988,NZL,"New Zealand",3,1,1958,0,0,1958,0
1988,NER,Niger,1,20,80000,0,0,80000,10200
1988,NGA,Nigeria,1,130,0,0,300000,300000,0
1988,PAK,Pakistan,1,196,0,0,1000000,1000000,0
1988,PRY,Paraguay,1,0,30000,0,15000,45000,0
1988,PER,Peru,1,38,0,0,0,0,0
1988,RWA,Rwanda,1,48,21628,50,0,21678,0
1988,SEN,Senegal,1,0,0,0,10000,10000,0
1988,ZAF,"South Africa",1,25,0,0,0,0,0
1988,SUN,"Soviet Union",1,0,0,0,0,0,0
1988,SDN,Sudan,1,96,1500000,0,1000000,2500000,0
1988,TZA,"Tanzania Uni Rep",1,0,6500,0,0,6500,0
1988,THA,Thailand,1,664,1112941,1878,0,1114819,169146
1988,TUR,Turkey,1,13,1000,0,500,1500,0
1988,USA,"United States",3,0,0,0,0,0,0
1988,VEN,Venezuela,2,66,5480,0,0,5480,0
1989,AGO,Angola,1,0,100000,0,0,100000,0
1989,AUS,Australia,1,9,0,0,0,0,0
1989,BGD,Bangladesh,1,180,200000,0,0,200000,0
1989,BRA,Brazil,4,137,700000,0,333944,1033944,0
1989,BDI,Burundi,1,12,3600,0,0,3600,0
1989,CHL,Chile,1,21,0,0,0,0,0
1989,CHN,"China P Rep",1,2000,100000000,10000,0,100010000,2789000
1989,COL,Colombia,1,16,0,0,0,0,0
1989,CIV,"Cote d'Ivoire",1,0,7000,0,0,7000,0
1989,DJI,Djibouti,1,10,150000,300,0,150300,1100
1989,ECU,Ecuador,1,35,30000,0,0,30000,15000
1989,SLV,"El Salvador",1,10,0,0,0,0,0
1989,FJI,Fiji,1,10,0,0,0,0,0
1989,GHA,Ghana,1,7,2800,0,0,2800,0
1989,GTM,Guatemala,1,10,0,0,0,0,0
1989,GUY,Guyana,1,0,0,0,0,0,0
1989,HTI,Haiti,2,0,24930,0,0,24930,0
1989,HKG,"Hong Kong (China)",1,3,1142,1,714,1857,0
1989,IND,India,2,1609,0,0,2000,2000,0
1989,IDN,Indonesia,2,18,61500,0,0,61500,0
1989,IRN,"Iran Islam Rep",1,0,150000,0,0,150000,2000
1989,JPN,Japan,1,10,0,0,0,0,0
1989,MWI,Malawi,1,13,0,0,100000,100000,0
1989,MLI,Mali,1,1,14635,0,0,14635,0
1989,MEX,Mexico,1,40,0,0,0,0,0
1989,MOZ,Mozambique,1,2,0,0,0,0,0
1989,NZL,"New Zealand",1,0,154,0,0,154,0
1989,PAK,Pakistan,1,20,142400,0,0,142400,0
1989,PER,Peru,1,38,0,0,500,500,0
1989,PHL,Philippines,2,44,307500,11,0,307511,6000
1989,SOM,Somalia,2,34,50000,0,0,50000,0
1989,SUN,"Soviet Union",1,17,0,0,0,0,640000
1989,ESP,Spain,1,12,0,0,0,0,375000
1989,LKA,"Sri Lanka",1,325,300000,1000,200000,501000,35000
1989,TZA,"Tanzania Uni Rep",1,10,141056,0,0,141056,0
1989,YMN,"Yemen Arab Rep",1,38,0,0,150000,150000,0
1989,YMD,"Yemen P Dem Rep",1,25,260000,0,80000,340000,33000
1989,ZMB,Zambia,1,0,800000,0,0,800000,0
1990,ARG,Argentina,1,21,2000,0,0,2000,0
1990,AUS,Australia,2,12,6000,0,0,6000,273700
1990,BGD,Bangladesh,2,231,2010000,1600,0,2011600,6000
1990,BLZ,Belize,1,0,0,0,0,0,2200
1990,BRA,Brazil,2,24,2800,0,0,2800,0
1990,CAN,Canada,1,8,0,0,0,0,8500
1990,CHL,Chile,1,0,2500,0,0,2500,0
1990,CHN,"China P Rep",3,495,42000000,5805,300000,42305805,803000
1990,COL,Colombia,4,10,20625,0,0,20625,0
1990,CUB,Cuba,2,4,5000,0,6000,11000,0
1990,ETH,Ethiopia,1,0,350000,0,0,350000,0
1990,HND,Honduras,1,5,42000,0,6000,48000,100000
1990,IND,India,4,224,0,0,2000,2000,0
1990,IDN,Indonesia,2,191,21000,0,0,21000,4800
1990,IRN,"Iran Islam Rep",1,0,0,0,0,0,77400
1990,JPN,Japan,1,27,0,81,507,588,1700000
1990,KEN,Kenya,1,44,0,0,0,0,0
1990,KOR,"Korea Rep",1,127,189233,27,0,189260,38000
1990,LSO,Lesotho,1,22,0,0,0,0,0
1990,MEX,Mexico,1,45,17800,100,0,17900,44000
1990,NPL,Nepal,1,30,2500,0,0,2500,0
1990,NIC,Nicaragua,1,4,106411,0,0,106411,0
1990,PRY,Paraguay,1,0,15000,0,0,15000,0
1990,PER,Peru,3,61,100,0,2500,2600,0
1990,PHL,Philippines,3,176,712736,0,0,712736,43
1990,SUN,"Soviet Union",3,19,23208,0,0,23208,177900
1990,LKA,"Sri Lanka",2,33,440000,0,0,440000,0
1990,TJK,Tajikistan,1,0,280,0,0,280,0
1990,TZA,"Tanzania Uni Rep",2,189,142000,0,20868,162868,280
1990,TUN,Tunisia,1,37,152000,0,0,152000,242800
1990,TUR,Turkey,2,69,4500,0,0,4500,150000
1990,USA,"United States",4,38,3350,0,0,3350,45000
1990,VNM,"Viet Nam",1,82,10000,200,0,10200,725
1990,YUG,Yugoslavia,1,0,0,0,0,0,766100
1990,COD,"Zaire/Congo Dem Rep",1,23,15000,500,12000,27500,0
1991,AFG,Afghanistan,3,1193,130000,0,9400,139400,60000
1991,AUT,Austria,1,5,0,0,0,0,82000
1991,BGD,Bangladesh,3,265,2790000,0,200000,2990000,150000
1991,BEN,Benin,1,3,0,0,0,0,0
1991,BRA,Brazil,1,20,17000,0,0,17000,2000
1991,KHM,Cambodia,1,100,650000,0,250000,900000,150000
1991,CMR,Cameroon,1,2,0,0,200,200,0
1991,TCD,Chad,1,39,0,14,0,14,0
1991,CHN,"China P Rep",3,1861,206000000,32227,4203500,210235727,8044120
1991,CRI,"Costa Rica",1,1,165000,21,20000,185021,0
1991,DOM,"Dominican Rep",1,10,0,0,0,0,0
1991,EGY,Egypt,1,1,0,8,200,208,0
1991,DFR,"Germany Fed Rep",1,5,0,0,0,0,56000
1991,GHA,Ghana,1,5,2000000,0,0,2000000,0
1991,IND,India,8,1016,8300000,0,400000,8700000,258000
1991,IDN,Indonesia,2,112,240000,0,0,240000,14800
1991,IRN,"Iran Islam Rep",4,56,200000,14,15000,215014,433400
1991,JAM,Jamaica,1,15,550000,0,1340,551340,30000
1991,JOR,Jordan,1,8,18000,0,0,18000,0
1991,KOR,"Korea Rep",1,54,0,36,1500,1536,105000
1991,LAO,"Lao P Dem Rep",1,0,332000,0,0,332000,0
1991,MWI,Malawi,1,472,0,0,150000,150000,24000
1991,MEX,Mexico,2,23,0,0,44000,44000,2000
1991,MMR,Myanmar,1,23,359976,0,0,359976,79840
1991,NPL,Nepal,1,51,450,32,0,482,0
1991,NZL,"New Zealand",3,0,248,0,0,248,0
1991,PAK,Pakistan,1,24,0,0,0,0,0
1991,PAN,Panama,1,12,20000,61,0,20061,0
1991,PHL,Philippines,3,70,0,0,823,823,1300
1991,ROU,Romania,1,108,7000,0,8000,15000,50000
1991,SUN,"Soviet Union",2,2,42000,0,0,42000,2022000
1991,LKA,"Sri Lanka",1,27,100000,0,197151,297151,30000
1991,THA,Thailand,2,17,14474,0,2100,16574,1478
1991,TUR,Turkey,1,42,500,0,0,500,25000
1991,USA,"United States",14,15,0,0,0,0,850000
1991,URY,Uruguay,1,0,1500,0,0,1500,0
1991,VNM,"Viet Nam",3,195,295000,14,600,295614,46700
1991,YEM,Yemen,1,0,0,0,30000,30000,0
1992,AFG,Afghanistan,2,600,4000,0,0,4000,4000
1992,ALB,Albania,1,11,35000,0,0,35000,7000
1992,DZA,Algeria,1,21,0,8,2250,2258,900
1992,ARG,Argentina,2,45,0,0,88074,88074,510000
1992,BGD,Bangladesh,3,17,0,200,75000,75200,0
1992,BOL,Bolivia,2,4,0,50,40000,40050,200000
1992,BRA,Brazil,4,107,145723,270,1500,147493,25800
1992,CHN,"China P Rep",6,540,210000,2035,472400,684435,509100
1992,CUB,Cuba,1,0,9127,0,0,9127,2590
1992,ECU,Ecuador,1,22,125000,0,80000,205000,20000
1992,SLV,"El Salvador",1,2,8000,0,0,8000,0
1992,FRA,France,1,3,0,0,0,0,0
1992,DEU,Germany,1,0,0,0,0,0,30100
1992,HKG,"Hong Kong (China)",1,5,1500,6,122,1628,50000
1992,IND,India,5,832,3070500,0,500,3071000,308950
1992,IDN,Indonesia,1,57,9330,249378,6845,265553,0
1992,IRN,"Iran Islam Rep",2,63,32500,0,2500,35000,3469400
1992,ITA,Italy,2,2,1000,0,0,1000,697300
1992,KOR,"Korea Rep",1,5,155,0,123,278,0
1992,LAO,"Lao P Dem Rep",1,10,0,150,0,150,21828
1992,MMR,Myanmar,1,5,4625,0,0,4625,55115
1992,NLD,Netherlands,1,0,0,0,0,0,27600
1992,PAK,Pakistan,2,1446,9888553,0,2951315,12839868,1000230
1992,PNG,"Papua New Guinea",1,0,90000,0,0,90000,0
1992,PRY,Paraguay,1,0,65575,0,0,65575,0
1992,PER,Peru,1,0,30000,0,0,30000,0
1992,PHL,Philippines,3,79,1053657,13,162,1053832,74200
1992,PRI,"Puerto Rico",1,18,600,0,0,600,200000
1992,RUS,Russia,1,0,0,0,0,0,48100
1992,SCG,"Serbia Montenegro",1,1,0,0,6000,6000,0
1992,LKA,"Sri Lanka",2,15,394810,0,261140,655950,252750
1992,VCT,"St Vincent and the Grenad",1,3,200,0,0,200,0
1992,TJK,Tajikistan,1,1346,63500,0,0,63500,300000
1992,URY,Uruguay,1,0,4700,0,0,4700,0
1992,VNM,"Viet Nam",2,56,102109,10,7579,109698,47700
1993,DZA,Algeria,1,22,0,16,0,16,0
1993,ARG,Argentina,3,0,0,0,0,0,1092000
1993,AUS,Australia,1,1,15000,30,5500,20530,4600
1993,BGD,Bangladesh,3,194,15676593,20,75000,15751613,0
1993,BLR,Belarus,1,0,40000,0,0,40000,100000
1993,BEL,Belgium,2,0,600,0,0,600,17000
1993,CAN,Canada,1,0,200,0,0,200,0
1993,CHL,Chile,1,109,1993,58,1225,3276,34000
1993,CHN,"China P Rep",4,1231,7000,400,0,7400,6088000
1993,COL,Colombia,1,63,80000,33,250,80283,0
1993,CRI,"Costa Rica",1,9,35000,1,3450,38451,0
1993,CUB,Cuba,2,46,540000,0,32000,572000,140000
1993,DJI,Djibouti,1,0,20000,0,0,20000,0
1993,DOM,"Dominican Rep",2,30,20000,0,0,20000,0
1993,ETH,Ethiopia,2,2,30000,0,4800,34800,0
1993,FRA,France,1,4,0,0,0,0,600000
1993,DEU,Germany,1,5,100000,0,0,100000,600000
1993,GIN,Guinea,1,0,6066,0,0,6066,0
1993,HTI,Haiti,1,13,5000,0,0,5000,0
1993,HND,Honduras,2,413,82447,0,0,82447,114300
1993,IND,India,5,1297,128000000,0,60000,128060000,7500000
1993,IDN,Indonesia,2,131,267553,0,0,267553,19301
1993,IRN,"Iran Islam Rep",3,781,484725,3,14000,498728,1226300
1993,IRL,Ireland,1,3,3500,0,0,3500,38000
1993,JAM,Jamaica,1,9,4290,0,82,4372,11000
1993,JPN,Japan,1,0,4800,0,0,4800,0
1993,KAZ,Kazakhstan,1,10,30000,0,0,30000,36532
1993,LUX,Luxembourg,1,0,0,0,0,0,10000
1993,MYS,Malaysia,1,30,20000,0,5000,25000,0
1993,MEX,Mexico,2,65,228500,0,32790,261290,95400
1993,NPL,Nepal,1,1048,553000,268,0,553268,200000
1993,NLD,Netherlands,1,1,13000,0,0,13000,53000
1993,PAK,Pakistan,1,15,261295,0,0,261295,0
1993,PNG,"Papua New Guinea",1,0,14000,0,40000,54000,2500
1993,PER,Peru,1,80,219000,0,0,219000,0
1993,PHL,Philippines,3,53,348080,4,0,348084,39600
1993,RUS,Russia,2,138,14300,453,0,14753,34000
1993,SEN,Senegal,1,0,5000,0,0,5000,0
1993,ZAF,"South Africa",1,12,0,0,15000,15000,0
1993,LKA,"Sri Lanka",2,8,290000,0,40000,330000,310
1993,SDN,Sudan,1,21,0,0,2000,2000,200
1993,TZA,"Tanzania Uni Rep",2,54,201513,30,280,201823,3510
1993,THA,Thailand,3,41,858763,254,30328,889345,1980950
1993,TTO,"Trinidad and Tobago",1,5,0,0,10,10,70
1993,TKM,Turkmenistan,1,0,300,0,120,420,99870
1993,UKR,Ukraine,2,9,325000,0,0,325000,239000
1993,GBR,"United Kingdom",2,4,600,0,0,600,187000
1993,USA,"United States",6,98,43900,0,0,43900,12290000
1993,VNM,"Viet Nam",1,64,15000,0,0,15000,10000
1993,YEM,Yemen,1,31,9000,0,12500,21500,1500
1994,DZA,Algeria,2,40,1200,0,30000,31200,0
1994,BGD,Bangladesh,4,116,325100,0,70000,395100,0
1994,BEL,Belgium,1,0,135,0,0,135,0
1994,BEN,Benin,1,0,14000,0,20000,34000,0
1994,BTN,Bhutan,1,22,600,0,0,600,0
1994,BFA,"Burkina Faso",1,22,66500,0,0,66500,0
1994,KHM,Cambodia,1,506,29000,0,0,29000,0
1994,CMR,Cameroon,1,6,0,0,0,0,0
1994,CHN,"China P Rep",6,1564,105900000,22385,5617000,111539385,7539100
1994,COL,Colombia,3,37,9519,50,8400,17969,0
1994,COG,Congo,1,0,16500,0,0,16500,0
1994,CRI,"Costa Rica",1,2,2000,0,556,2556,3000
1994,CUB,Cuba,1,12,38600,0,0,38600,0
1994,DJI,Djibouti,1,145,100000,0,20000,120000,2119
1994,EGY,Egypt,1,600,110660,0,50000,160660,140000
1994,ETH,Ethiopia,1,4,43000,14,0,43014,3500
1994,FRA,France,3,13,410,0,0,410,100000
1994,DEU,Germany,2,2,0,0,0,0,393500
1994,GRC,Greece,1,14,1000,0,0,1000,437700
1994,GTM,Guatemala,1,10,600,0,0,600,0
1994,HND,Honduras,2,151,0,0,15500,15500,0
1994,HKG,"Hong Kong (China)",1,1,4000,17,0,4017,37000
1994,IND,India,2,2015,12000000,100,62500,12062600,175000
1994,IDN,Indonesia,6,59,327771,0,1000,328771,23245
1994,IRN,"Iran Islam Rep",3,39,95000,0,0,95000,142000
1994,ITA,Italy,1,68,7000,0,10300,17300,9300000
1994,LAO,"Lao P Dem Rep",1,0,190000,0,0,190000,0
1994,MDA,"Moldova Rep",1,47,25000,0,0,25000,300000
1994,MNG,Mongolia,1,5,0,0,0,0,0
1994,NZL,"New Zealand",1,0,157,0,0,157,0
1994,NER,Niger,1,60,0,0,61992,61992,0
1994,NGA,Nigeria,1,30,180000,0,400000,580000,66500
1994,PAK,Pakistan,1,316,840000,16,0,840016,92000
1994,PER,Peru,2,85,89000,130,12000,101130,50000
1994,PHL,Philippines,4,62,794529,0,17054,811583,4142
1994,ROU,Romania,1,2,0,0,0,0,3000
1994,RUS,Russia,5,46,797204,0,429,797633,281000
1994,SEN,Senegal,1,0,0,0,17500,17500,0
1994,SOM,Somalia,1,100,0,0,0,0,0
1994,ZAF,"South Africa",1,0,11000,0,0,11000,0
1994,ESP,Spain,1,10,0,0,0,0,0
1994,LKA,"Sri Lanka",3,0,0,0,728150,728150,0
1994,SDN,Sudan,1,8,5965,0,0,5965,0
1994,TJK,Tajikistan,1,0,5000,0,1051,6051,0
1994,TZA,"Tanzania Uni Rep",1,31,0,0,7000,7000,0
1994,THA,Thailand,3,102,109113,3,62141,171257,268000
1994,TGO,Togo,1,0,10000,0,1500,11500,0
1994,GBR,"United Kingdom",2,7,700,0,0,700,236000
1994,USA,"United States",1,37,14000,70,0,14070,700000
1994,VEN,Venezuela,1,26,0,0,0,0,0
1994,VNM,"Viet Nam",1,310,382000,0,0,382000,206000
1994,COD,"Zaire/Congo Dem Rep",1,39,0,0,50,50,0
1995,AFG,Afghanistan,2,27,0,0,7500,7500,0
1995,ALB,Albania,2,4,3500,0,0,3500,0
1995,ARG,Argentina,2,0,2500,0,0,2500,0
1995,AUT,Austria,1,2,0,0,0,0,200
1995,AZE,Azerbaijan,3,5,1502800,0,156000,1658800,16200
1995,BGD,Bangladesh,4,741,14358331,0,360000,14718331,375300
1995,BLZ,Belize,1,0,2600,0,0,2600,500
1995,BEN,Benin,1,20,115000,0,8000,123000,3100
1995,BWA,Botswana,1,20,3500,0,2000,5500,0
1995,BRA,Brazil,3,110,0,0,33800,33800,3000
1995,CAN,Canada,1,0,5600,0,0,5600,73300
1995,CAF,"Central African Rep",1,0,1957,0,1957,3914,0
1995,TCD,Chad,1,2,40343,0,40343,80686,0
1995,CHL,Chile,1,28,0,0,0,0,0
1995,CHN,"China P Rep",3,1618,125500000,70411,1000000,126570411,6720000
1995,COL,Colombia,1,69,0,0,86000,86000,0
1995,CUB,Cuba,1,0,33180,0,0,33180,0
1995,EGY,Egypt,1,7,0,0,3000,3000,0
1995,SLV,"El Salvador",1,8,1500,0,0,1500,0
1995,ETH,Ethiopia,1,27,93875,0,0,93875,500
1995,GEO,Georgia,1,1,300,0,0,300,2200
1995,GHA,Ghana,1,145,500000,0,200000,700000,12500
1995,GTM,Guatemala,1,31,7100,55,280,7435,0
1995,HND,Honduras,1,14,25000,0,0,25000,4000
1995,IND,India,3,1514,32704000,0,3000,32707000,260252
1995,IDN,Indonesia,5,140,249700,472,10000,260172,50400
1995,IRN,"Iran Islam Rep",3,27,6000,11,250,6261,95900
1995,JPN,Japan,1,0,12000,0,0,12000,74300
1995,PRK,"Korea Dem P Rep",2,68,5700000,0,500000,6200000,15000000
1995,LAO,"Lao P Dem Rep",2,0,591400,0,0,591400,0
1995,LBY,"Libyan Arab Jamah",1,0,0,0,0,0,42200
1995,MKD,"Macedonia FRY",1,0,1500,0,0,1500,245000
1995,MWI,Malawi,2,1,0,0,1300,1300,0
1995,MRT,Mauritania,1,0,408,0,192,600,0
1995,MAR,Morocco,3,791,38000,0,0,38000,9000
1995,MMR,Myanmar,1,51,19544,0,12401,31945,0
1995,NPL,Nepal,1,140,10000,0,3000,13000,1200
1995,NOR,Norway,1,1,4000,0,0,4000,300000
1995,PAK,Pakistan,3,1063,1855000,0,0,1855000,0
1995,PAN,Panama,1,1,500,0,0,500,7000
1995,PRY,Paraguay,2,0,275000,0,0,275000,0
1995,PHL,Philippines,6,476,119178,7,10000,129185,700942
1995,ROU,Romania,1,2,0,0,5000,5000,3400
1995,SOM,Somalia,1,20,8500,0,0,8500,0
1995,ZAF,"South Africa",1,207,4500,0,0,4500,10000
1995,LKA,"Sri Lanka",1,3,0,0,120000,120000,400
1995,TZA,"Tanzania Uni Rep",2,3,1850,0,20000,21850,0
1995,THA,Thailand,1,231,4224000,0,56984,4280984,140500
1995,TGO,Togo,2,3,110000,0,75000,185000,0
1995,TUR,Turkey,2,63,300200,118,6500,306818,73500
1995,UKR,Ukraine,1,0,1700000,0,0,1700000,0
1995,USA,"United States",6,19,115300,0,0,115300,3245000
1995,VNM,"Viet Nam",1,253,400000,0,0,400000,86000
1996,AFG,Afghanistan,1,70,9855,0,0,9855,0
1996,DZA,Algeria,1,4,0,101,0,101,0
1996,AUS,Australia,2,5,12700,26,500,13226,336300
1996,AUT,Austria,1,0,0,0,0,0,5000
1996,BGD,Bangladesh,2,55,5828319,0,0,5828319,10000
1996,BLR,Belarus,1,0,0,0,0,0,0
1996,BEN,Benin,1,11,147901,0,826,148727,0
1996,BRA,Brazil,1,15,0,0,7000,7000,0
1996,KHM,Cambodia,1,59,1300000,0,0,1300000,1500
1996,CAN,Canada,1,10,0,0,12000,12000,729600
1996,CAF,"Central African Rep",1,7,16000,0,1500,17500,0
1996,CHN,"China P Rep",4,4091,150000000,234000,4440000,154674000,18914500
1996,COL,Colombia,2,12,180000,0,200,180200,0
1996,CRI,"Costa Rica",1,6,20000,0,0,20000,250000
1996,CIV,"Cote d'Ivoire",1,28,0,0,0,0,0
1996,CUB,Cuba,2,3,10866,0,0,10866,0
1996,CZE,"Czech Rep",1,1,60,0,0,60,36000
1996,DOM,"Dominican Rep",1,3,0,0,1000,1000,0
1996,EGY,Egypt,1,12,260,0,0,260,0
1996,ETH,Ethiopia,2,40,90000,0,25000,115000,0
1996,FRA,France,2,4,1380,0,0,1380,6000
1996,GUF,"French Guiana",1,0,0,0,70000,70000,0
1996,GMB,"Gambia The",1,0,4000,0,0,4000,0
1996,GUY,Guyana,1,0,28000,0,10000,38000,0
1996,HTI,Haiti,2,18,40,0,0,40,0
1996,HND,Honduras,1,7,75000,0,0,75000,31000
1996,HUN,Hungary,1,0,0,0,200,200,0
1996,IND,India,6,1291,7170000,10,100000,7270010,193980
1996,IDN,Indonesia,5,87,824471,28,0,824499,562430
1996,IRN,"Iran Islam Rep",3,49,2000,0,2000,4000,36930
1996,ITA,Italy,2,17,500,0,0,500,32000
1996,KEN,Kenya,1,0,0,0,1000,1000,0
1996,PRK,"Korea Dem P Rep",1,116,3270000,0,0,3270000,2200000
1996,KOR,"Korea Rep",1,85,31865,0,28500,60365,120000
1996,LAO,"Lao P Dem Rep",1,30,420000,0,0,420000,0
1996,MYS,Malaysia,1,0,418,0,0,418,0
1996,MEX,Mexico,1,0,9000,0,0,9000,0
1996,MNG,Mongolia,1,41,0,0,0,0,0
1996,MAR,Morocco,1,25,60000,0,0,60000,55000
1996,NPL,Nepal,2,788,138600,132,13650,152382,0
1996,PAK,Pakistan,1,111,1300000,0,0,1300000,0
1996,PHL,Philippines,1,0,0,0,96000,96000,0
1996,PRT,Portugal,2,10,3050,0,0,3050,13000
1996,RUS,Russia,2,4,234000,0,0,234000,298400
1996,SLE,"Sierra Leone",1,12,200000,0,0,200000,0
1996,SOM,Somalia,1,3,100,0,0,100,0
1996,ZAF,"South Africa",2,34,7000,30,500,7530,6860
1996,ESP,Spain,1,1,4000,0,0,4000,576600
1996,LKA,"Sri Lanka",1,0,0,0,10000,10000,0
1996,SDN,Sudan,3,152,46200,18500,55700,120400,0
1996,TJK,Tajikistan,1,0,180000,0,0,180000,0
1996,THA,Thailand,1,91,5000000,0,0,5000000,500
1996,TTO,"Trinidad and Tobago",1,0,200,0,0,200,0
1996,UKR,Ukraine,1,0,10000,0,0,10000,0
1996,USA,"United States",4,72,243115,0,0,243115,2720000
1996,VEN,Venezuela,2,0,35000,0,16500,51500,0
1996,VNM,"Viet Nam",2,222,375000,0,0,375000,151400
1996,YEM,Yemen,2,345,129000,0,114210,243210,1210000
1997,AFG,Afghanistan,2,70,20000,0,750,20750,0
1997,ALB,Albania,1,0,8000,0,0,8000,0
1997,DZA,Algeria,1,4,0,0,3000,3000,0
1997,ARG,Argentina,1,0,12500,0,0,12500,0
1997,ARM,Armenia,1,4,7000,0,0,7000,8000
1997,AUS,Australia,1,0,400,0,0,400,0
1997,AUT,Austria,1,3,0,0,0,0,175000
1997,AZE,Azerbaijan,1,11,75000,0,0,75000,25000
1997,BGD,Bangladesh,1,79,800000,30,100000,900030,229000
1997,BEN,Benin,1,0,51000,0,0,51000,0
1997,BOL,Bolivia,2,56,190000,0,0,190000,70000
1997,BRA,Brazil,3,90,0,200,62000,62200,0
1997,BGR,Bulgaria,1,0,200,0,0,200,0
1997,CAN,Canada,1,4,29000,0,0,29000,120000
1997,CHL,Chile,1,22,65800,0,11000,76800,182400
1997,CHN,"China P Rep",6,1090,7300000,26229,363000,7689229,2439600
1997,COL,Colombia,1,2,15000,0,0,15000,3000
1997,CUB,Cuba,1,0,35000,0,0,35000,0
1997,CZE,"Czech Rep",1,29,87725,2409,11973,102107,1850000
1997,ECU,Ecuador,2,245,46907,91,2009,49007,271000
1997,EGY,Egypt,1,4,0,0,0,0,1000
1997,ETH,Ethiopia,2,326,65000,22,0,65022,0
1997,GEO,Georgia,3,7,300,0,200,500,29500
1997,DEU,Germany,1,0,5200,0,0,5200,360000
1997,GRC,Greece,1,9,0,0,0,0,160000
1997,HKG,"Hong Kong (China)",1,80,0,0,0,0,10000
1997,HUN,Hungary,1,0,0,0,0,0,10000
1997,IND,India,6,2357,30259000,20,0,30259020,224800
1997,IRN,"Iran Islam Rep",2,13,1400,0,0,1400,25000
1997,ISR,Israel,1,15,0,0,0,0,40000
1997,JOR,Jordan,1,2,0,0,0,0,1000
1997,KEN,Kenya,1,86,900000,0,0,900000,11800
1997,PRK,"Korea Dem P Rep",1,0,0,0,29000,29000,0
1997,KOR,"Korea Rep",2,15,0,0,115,115,1650
1997,KWT,Kuwait,1,2,200,0,0,200,0
1997,MWI,Malawi,1,0,400000,0,0,400000,0
1997,MDA,"Moldova Rep",1,9,2148,0,96,2244,50000
1997,MAR,Morocco,1,60,0,0,0,0,0
1997,MOZ,Mozambique,1,35,400000,0,0,400000,0
1997,MMR,Myanmar,1,68,103650,0,33768,137418,0
1997,NZL,"New Zealand",1,0,200,0,0,200,0
1997,PAK,Pakistan,2,171,836328,56,15000,851384,0
1997,PRY,Paraguay,1,0,75000,0,0,75000,1687
1997,PHL,Philippines,1,18,105000,0,0,105000,76
1997,POL,Poland,1,55,162500,0,62000,224500,3500000
1997,ROU,Romania,1,20,0,0,122320,122320,110000
1997,RUS,Russia,1,2,500,0,0,500,174100
1997,SYC,Seychelles,1,5,1125,2,110,1237,1700
1997,SVK,Slovakia,1,0,0,0,0,0,60000
1997,SOM,Somalia,2,2311,1002000,0,230000,1232000,0
1997,ZAF,"South Africa",1,0,300,7,0,307,0
1997,ESP,Spain,1,5,400,0,0,400,0
1997,LKA,"Sri Lanka",1,10,5000,0,0,5000,420
1997,SDN,Sudan,1,8,100000,0,0,100000,0
1997,CHE,Switzerland,1,0,0,0,0,0,68500
1997,TWN,"Taiwan (China)",1,10,0,0,0,0,58300
1997,TZA,"Tanzania Uni Rep",2,83,8028,0,2104,10132,0
1997,THA,Thailand,1,14,0,0,0,0,0
1997,UGA,Uganda,1,100,150000,0,3500,153500,1000
1997,UKR,Ukraine,1,0,0,0,0,0,17000
1997,GBR,"United Kingdom",2,1,0,0,0,0,248400
1997,USA,"United States",8,72,190950,24,400,191374,7345000
1997,VEN,Venezuela,1,3,0,0,18000,18000,0
1997,COD,"Zaire/Congo Dem Rep",1,0,26000,0,9506,35506,0
1998,AFG,Afghanistan,1,30,0,300,0,300,0
1998,ARG,Argentina,1,19,360000,0,0,360000,1100000
1998,ARM,Armenia,1,0,0,0,144,144,120
1998,AUS,Australia,6,20,15175,0,0,15175,384000
1998,BGD,Bangladesh,1,1050,15000000,50,0,15000050,4300000
1998,BEL,Belgium,1,1,140,0,0,140,10000
1998,BEN,Benin,1,0,400000,0,20000,420000,0
1998,BRA,Brazil,5,13,37000,0,10500,47500,1000
1998,CAN,Canada,1,3,3100,0,0,3100,0
1998,CAF,"Central African Rep",1,0,0,0,9200,9200,0
1998,TCD,Chad,1,0,0,0,1000,1000,0
1998,CHN,"China P Rep",5,4250,225241300,123000,17350000,242714300,31743524
1998,COG,Congo,1,0,20000,0,0,20000,59
1998,CZE,"Czech Rep",1,6,0,0,0,0,52000
1998,GRC,Greece,1,3,900,0,0,900,0
1998,IND,India,3,2131,29652200,0,0,29652200,528600
1998,IDN,Indonesia,1,4,100000,0,0,100000,0
1998,IRN,"Iran Islam Rep",3,157,40576,24,16000,56600,148500
1998,ISR,Israel,1,0,1000,0,0,1000,0
1998,JPN,Japan,1,16,24000,33,0,24033,0
1998,KEN,Kenya,1,40,0,0,200,200,0
1998,PRK,"Korea Dem P Rep",1,50,10000,172,0,10172,0
1998,KOR,"Korea Rep",1,403,0,0,121000,121000,1480000
1998,KGZ,Kyrgyzstan,1,1,0,0,7728,7728,2400
1998,LBR,Liberia,1,10,5000,0,0,5000,0
1998,MDG,Madagascar,1,0,20000,0,0,20000,0
1998,MWI,Malawi,1,4,15000,0,0,15000,89
1998,MYS,Malaysia,1,0,2500,0,0,2500,0
1998,MLI,Mali,2,3,1784,0,4650,6434,0
1998,MEX,Mexico,2,432,30000,0,0,30000,602700
1998,NPL,Nepal,2,310,20000,0,50000,70000,27000
1998,NLD,Netherlands,1,0,2000,0,0,2000,530000
1998,NZL,"New Zealand",1,0,200,0,0,200,75000
1998,NER,Niger,1,0,0,0,20000,20000,0
1998,NGA,Nigeria,2,15,0,0,107000,107000,0
1998,PAK,Pakistan,1,1000,200000,0,0,200000,0
1998,PRY,Paraguay,1,55,0,0,0,0,5000
1998,POL,Poland,1,9,1200,0,0,1200,0
1998,ROU,Romania,1,31,12000,0,0,12000,150000
1998,RUS,Russia,4,14,154100,0,36000,190100,16500
1998,SEN,Senegal,1,0,300000,0,0,300000,0
1998,SVK,Slovakia,1,54,10850,61,756,11667,45000
1998,LKA,"Sri Lanka",2,3,289485,0,75000,364485,0
1998,SDN,Sudan,1,103,900000,0,100000,1000000,40000
1998,TWN,"Taiwan (China)",1,3,300,0,0,300,19000
1998,TJK,Tajikistan,2,51,40935,39,916,41890,66000
1998,TZA,"Tanzania Uni Rep",2,61,4600,0,0,4600,0
1998,TGO,Togo,1,0,30405,0,0,30405,0
1998,TUR,Turkey,3,92,1201000,47,40000,1241047,1000000
1998,UGA,Uganda,1,0,13000,0,2200,15200,0
1998,UKR,Ukraine,1,18,0,230,24340,24570,1259
1998,GBR,"United Kingdom",1,5,300,0,0,300,500000
1998,USA,"United States",7,31,32000,0,5000,37000,1062000
1998,URY,Uruguay,1,1,9300,0,0,9300,5000
1998,VNM,"Viet Nam",1,45,31030,5,1470,32505,13700
1998,YEM,Yemen,2,70,3240,0,0,3240,0
1998,ZMB,Zambia,1,0,1300000,0,0,1300000,20700
1998,ZWE,Zimbabwe,1,36,0,0,0,0,0
1999,AFG,Afghanistan,1,0,500,0,0,500,0
1999,DZA,Algeria,1,12,0,2,700,702,0
1999,AUT,Austria,1,3,0,0,0,0,32000
1999,BGD,Bangladesh,5,196,471250,170,24000,495420,0
1999,BLR,Belarus,1,2,2000,0,0,2000,4380
1999,BEN,Benin,1,3,47000,0,10469,57469,215
1999,BOL,Bolivia,1,0,1000,0,600,1600,0
1999,BRA,Brazil,1,7,0,0,0,0,0
1999,BFA,"Burkina Faso",1,6,800,0,760,1560,0
1999,KHM,Cambodia,2,7,634574,0,25805,660379,500
1999,CMR,Cameroon,1,24,0,0,1000,1000,0
1999,CAF,"Central African Rep",2,0,20000,0,25919,45919,0
1999,TCD,Chad,1,0,128506,0,45000,173506,0
1999,CHN,"China P Rep",6,1185,104928000,24000,2245000,107197000,9254400
1999,COL,Colombia,3,41,100000,40,51350,151390,3
1999,COG,Congo,1,2,40000,0,2000,42000,0
1999,CRI,"Costa Rica",1,9,5372,0,4621,9993,1000
1999,SLV,"El Salvador",1,7,5450,0,0,5450,1500
1999,ETH,Ethiopia,6,48,22255,0,125000,147255,2700
1999,FRA,France,3,36,3900,5,200,4105,500000
1999,GMB,"Gambia The",1,53,27000,0,5000,32000,0
1999,DEU,Germany,1,7,100000,0,0,100000,430000
1999,GHA,Ghana,1,52,291573,29,33000,324602,21000
1999,GTM,Guatemala,1,12,2283,0,3740,6023,1000
1999,HTI,Haiti,1,13,0,0,50,50,0
1999,HND,Honduras,1,34,500000,1,3000,503001,1500
1999,HUN,Hungary,2,8,131441,0,2054,133495,293400
1999,IND,India,2,554,27620000,0,0,27620000,2400
1999,IDN,Indonesia,1,12,16000,0,0,16000,0
1999,IRN,"Iran Islam Rep",4,81,25250,124,0,25374,43000
1999,JPN,Japan,2,60,24000,28,111,24139,107000
1999,PRK,"Korea Dem P Rep",1,42,39136,94,2905,42135,2000
1999,KOR,"Korea Rep",1,64,24408,0,5800,30208,332000
1999,MWI,Malawi,1,0,2000,0,0,2000,0
1999,MYS,Malaysia,1,1,2000,0,0,2000,0
1999,MLI,Mali,1,2,2000,0,200,2200,0
1999,MRT,Mauritania,2,0,3800,0,20000,23800,0
1999,MEX,Mexico,4,654,532200,160,86000,618360,451300
1999,MDA,"Moldova Rep",1,0,960,0,753,1713,4000
1999,MOZ,Mozambique,1,23,70000,0,0,70000,12400
1999,MMR,Myanmar,1,22,0,0,50000,50000,0
1999,NPL,Nepal,1,170,18000,68,0,18068,2000
1999,NZL,"New Zealand",1,0,350,0,0,350,0
1999,NIC,Nicaragua,1,11,100000,0,7105,107105,500
1999,NER,Niger,2,14,11606,0,12789,24395,0
1999,NGA,Nigeria,3,89,80000,0,37000,117000,0
1999,PAK,Pakistan,2,34,0,43,1000,1043,0
1999,PAN,Panama,2,1,500,0,395,895,0
1999,PNG,"Papua New Guinea",1,2,0,0,38000,38000,43228
1999,PER,Peru,2,74,240000,1200,250000,491200,0
1999,PHL,Philippines,4,164,2100250,111,4655,2105016,24000
1999,ROU,Romania,2,34,8418,25,590,9033,60000
1999,RUS,Russia,1,0,0,0,1200,1200,0
1999,SCG,"Serbia Montenegro",2,11,60639,0,10369,71008,0
1999,SVK,Slovakia,1,2,35207,0,941,36148,113300
1999,ZAF,"South Africa",2,27,2300,0,0,2300,19600
1999,LKA,"Sri Lanka",1,6,0,0,375000,375000,0
1999,SDN,Sudan,4,38,235841,0,45000,280841,0
1999,CHE,Switzerland,1,3,0,0,0,0,330000
1999,TJK,Tajikistan,1,27,6366,23,3003,9392,6154
1999,THA,Thailand,6,22,283562,0,200,283762,13267
1999,TGO,Togo,1,0,65000,0,0,65000,0
1999,GBR,"United Kingdom",1,0,330,0,0,330,32680
1999,USA,"United States",1,0,100,0,0,100,300
1999,VEN,Venezuela,3,30005,417547,3068,122888,543503,3160000
1999,VNM,"Viet Nam",3,789,5639150,576,143555,5783281,309500
1999,YEM,Yemen,1,0,12250,0,7500,19750,0
1999,COD,"Zaire/Congo Dem Rep",1,2,65000,0,13000,78000,0
2000,DZA,Algeria,4,44,100,5,100,205,0
2000,AGO,Angola,4,46,70000,11,9000,79011,10000
2000,ARG,Argentina,4,13,30000,40,7800,37840,300000
2000,AUS,Australia,1,0,600,0,0,600,265000
2000,BGD,Bangladesh,3,43,2667138,60,12000,2679198,500000
2000,BTN,Bhutan,1,200,0,0,1000,1000,0
2000,BOL,Bolivia,2,30,7000,10,0,7010,0
2000,BWA,Botswana,1,3,106776,0,32000,138776,5000
2000,BRA,Brazil,4,48,17000,0,70000,87000,0
2000,BDI,Burundi,1,0,0,0,500,500,0
2000,KHM,Cambodia,1,347,3448000,53,0,3448053,160000
2000,CMR,Cameroon,1,3,500,0,0,500,0
2000,CHL,Chile,2,16,171266,0,10401,181667,30000
2000,CHN,"China P Rep",9,422,709000,407,53500,762907,315366
2000,COL,Colombia,3,113,40000,0,39000,79000,0
2000,HRV,Croatia,1,0,600,0,0,600,0
2000,CUB,Cuba,1,2,675,0,0,675,0
2000,CZE,"Czech Rep",1,0,0,0,0,0,80000
2000,ECU,Ecuador,1,34,0,32,0,32,0
2000,SLV,"El Salvador",1,2,400,0,0,400,0
2000,ETH,Ethiopia,2,69,30000,0,0,30000,0
2000,FJI,Fiji,1,4,0,0,0,0,0
2000,FRA,France,6,5,2300,12,0,2312,0
2000,GRC,Greece,2,1,6600,0,0,6600,0
2000,GTM,Guatemala,2,36,2700,36,250,2986,0
2000,HTI,Haiti,2,16,0,0,1200,1200,0
2000,HUN,Hungary,2,1,2000,0,0,2000,55000
2000,IND,India,6,2086,50134035,16,252000,50386051,907500
2000,IDN,Indonesia,3,264,475852,21,0,475873,113000
2000,IRN,"Iran Islam Rep",3,10,400,0,0,400,6000
2000,ITA,Italy,4,46,46000,22,0,46022,8050000
2000,JPN,Japan,1,18,360000,110,0,360110,7440000
2000,KAZ,Kazakhstan,1,0,2500,0,0,2500,1500
2000,KOR,"Korea Rep",2,20,500,3,2586,3089,50000
2000,LAO,"Lao P Dem Rep",1,15,450000,0,0,450000,1000
2000,MWI,Malawi,1,0,20000,0,0,20000,1000
2000,MYS,Malaysia,1,12,8000,0,0,8000,1000
2000,MLI,Mali,1,15,0,0,0,0,0
2000,MEX,Mexico,3,139,2000,0,0,2000,0
2000,MAR,Morocco,2,6,950,0,0,950,0
2000,MOZ,Mozambique,1,800,4500000,0,0,4500000,419200
2000,NAM,Namibia,1,0,5000,0,0,5000,0
2000,NPL,Nepal,1,144,50000,70,0,50070,6300
2000,NZL,"New Zealand",1,0,0,0,0,0,1000
2000,NIC,Nicaragua,1,0,5500,0,0,5500,0
2000,NER,Niger,1,2,4156,3,0,4159,0
2000,NGA,Nigeria,6,4,500,0,5000,5500,6705
2000,NOR,Norway,1,0,600,0,0,600,0
2000,PAN,Panama,1,1,0,0,1000,1000,1300
2000,PER,Peru,1,22,0,0,50,50,0
2000,PHL,Philippines,3,55,160393,0,5250,165643,4080
2000,ROU,Romania,2,9,63000,0,431,63431,100500
2000,RUS,Russia,8,3,76501,0,0,76501,43895
2000,SEN,Senegal,1,0,0,0,0,0,0
2000,SCG,"Serbia Montenegro",2,0,6000,0,0,6000,0
2000,SOM,Somalia,3,0,153500,0,220000,373500,0
2000,ZAF,"South Africa",3,93,3000,0,200,3200,160000
2000,ESP,Spain,2,24,1000,0,0,1000,75000
2000,LKA,"Sri Lanka",2,5,400000,0,0,400000,3000
2000,SWZ,Swaziland,1,0,272000,0,0,272000,50
2000,TZA,"Tanzania Uni Rep",1,36,0,17,1800,1817,0
2000,THA,Thailand,4,107,3323231,570,0,3323801,109056
2000,TUR,Turkey,1,2,1000,0,0,1000,40000
2000,GBR,"United Kingdom",3,0,1440,0,0,1440,5918150
2000,USA,"United States",8,8,1646,0,2000,3646,286000
2000,URY,Uruguay,1,0,5000,0,0,5000,0
2000,VEN,Venezuela,2,15,27000,4,0,27004,0
2000,VNM,"Viet Nam",2,496,5025000,7,0,5025007,265000
2000,ZMB,Zambia,1,0,12000,0,0,12000,0
2000,ZWE,Zimbabwe,1,70,200000,0,66000,266000,72900
2001,DZA,Algeria,1,921,45000,423,0,45423,300000
2001,AGO,Angola,2,57,39928,5,0,39933,0
2001,ARG,Argentina,3,1,251300,0,0,251300,750000
2001,AUS,Australia,4,4,3970,31,0,4001,225000
2001,BGD,Bangladesh,2,9,700000,0,0,700000,0
2001,BOL,Bolivia,1,41,357250,0,0,357250,121000
2001,BIH,Bosnia-Hercegovenia,1,0,9000,0,0,9000,0
2001,BRA,Brazil,3,85,1750,196,9100,11046,45000
2001,KHM,Cambodia,1,56,1669182,0,0,1669182,15000
2001,CMR,Cameroon,1,30,0,0,1500,1500,0
2001,SPI,"Canary Is",1,7,300,0,0,300,0
2001,TCD,Chad,1,100,175763,0,0,175763,1000
2001,CHL,Chile,3,4,12245,0,314,12559,8900
2001,CHN,"China P Rep",8,402,2090000,3209,252630,2345839,711000
2001,COL,Colombia,2,0,6000,0,0,6000,0
2001,CRI,"Costa Rica",1,0,1437,0,0,1437,0
2001,HRV,Croatia,1,0,1200,0,0,1200,0
2001,ECU,Ecuador,2,58,9500,30,0,9530,0
2001,SLV,"El Salvador",1,0,1000,0,0,1000,0
2001,ETH,Ethiopia,3,5,39500,0,0,39500,0
2001,FRA,France,5,3,16881,1,0,16882,132350
2001,GMB,"Gambia The",1,1,250,0,0,250,0
2001,GHA,Ghana,1,12,139000,25,5000,144025,0
2001,GRC,Greece,2,11,1050,0,0,1050,0
2001,GIN,Guinea,1,9,220000,0,0,220000,0
2001,HTI,Haiti,1,26,5070,11,0,5081,0
2001,HUN,Hungary,1,0,10000,0,0,10000,5000
2001,IND,India,9,581,20610000,40,0,20610040,361924
2001,IDN,Indonesia,4,402,80000,4,5690,85694,10000
2001,IRN,"Iran Islam Rep",4,476,1205250,284,0,1205534,103800
2001,ITA,Italy,2,2,0,0,0,0,100000
2001,JPN,Japan,1,1,138,0,0,138,0
2001,KAZ,Kazakhstan,1,0,3668,0,0,3668,0
2001,KEN,Kenya,1,4,0,0,0,0,38
2001,PRK,"Korea Dem P Rep",2,124,157500,84,30000,187584,9400
2001,KOR,"Korea Rep",2,70,310000,0,0,310000,76000
2001,LAO,"Lao P Dem Rep",1,0,453000,0,0,453000,0
2001,MWI,Malawi,2,59,508750,0,0,508750,6700
2001,MYS,Malaysia,4,11,33200,0,0,33200,0
2001,MLI,Mali,1,2,3500,0,0,3500,0
2001,MRT,Mauritania,1,0,0,0,3000,3000,0
2001,MEX,Mexico,1,21,0,0,0,0,0
2001,MNG,Mongolia,1,0,4000,0,0,4000,0
2001,MAR,Morocco,1,15,300,0,0,300,2200
2001,MOZ,Mozambique,2,79,749326,0,0,749326,36000
2001,MMR,Myanmar,1,51,0,0,3750,3750,0
2001,NER,Niger,1,4,20000,0,0,20000,0
2001,NGA,Nigeria,3,200,84065,50,5802,89917,3000
2001,NOR,Norway,1,0,1500,0,0,1500,0
2001,PAK,Pakistan,1,210,400000,179,0,400179,246000
2001,PAN,Panama,1,0,0,0,775,775,0
2001,PER,Peru,3,15,66300,10,0,66310,0
2001,PHL,Philippines,3,43,91300,0,0,91300,8000
2001,POL,Poland,1,27,15000,0,0,15000,700000
2001,PRT,Portugal,1,6,0,0,200,200,0
2001,PRI,"Puerto Rico",1,2,9300,0,180,9480,146000
2001,ROU,Romania,2,7,14800,3,0,14803,135000
2001,RUS,Russia,3,37,375305,0,0,375305,291000
2001,RWA,Rwanda,2,12,3000,0,0,3000,0
2001,WSM,Samoa,1,0,0,0,0,0,1500
2001,SVK,Slovakia,1,1,0,0,0,0,6000
2001,SOM,Somalia,1,0,6500,0,0,6500,0
2001,ZAF,"South Africa",2,5,42656,12,0,42668,0
2001,LKA,"Sri Lanka",1,0,0,0,160,160,0
2001,SDN,Sudan,1,3,97000,0,0,97000,2000
2001,TJK,Tajikistan,1,0,2190,0,0,2190,0
2001,TZA,"Tanzania Uni Rep",1,5,0,0,200,200,0
2001,THA,Thailand,6,222,465510,139,4730,470379,28500
2001,TLS,Timor-Leste,1,1,2508,0,0,2508,0
2001,TUR,Turkey,3,12,2520,0,0,2520,25000
2001,UGA,Uganda,2,1,500,0,300,800,0
2001,UKR,Ukraine,1,9,300000,0,0,300000,15000
2001,GBR,"United Kingdom",2,0,240,0,0,240,0
2001,USA,"United States",5,12,19300,0,4500,23800,33000
2001,URY,Uruguay,1,0,5000,0,0,5000,0
2001,VNM,"Viet Nam",4,339,1608445,6,0,1608451,88700
2001,YEM,Yemen,1,33,0,0,0,0,0
2001,COD,"Zaire/Congo Dem Rep",2,50,13000,26,0,13026,0
2001,ZMB,Zambia,1,5,617900,0,0,617900,0
2001,ZWE,Zimbabwe,1,13,30000,0,0,30000,3600
2002,AFG,Afghanistan,4,81,5545,0,0,5545,0
2002,ALB,Albania,1,1,66884,0,0,66884,17500
2002,DZA,Algeria,3,48,2285,20,0,2305,1500
2002,AGO,Angola,1,8,0,0,0,0,0
2002,ARG,Argentina,2,8,12000,0,0,12000,0
2002,AUT,Austria,1,9,60000,0,0,60000,2400000
2002,BGD,Bangladesh,1,10,1500000,0,0,1500000,0
2002,BEL,Belgium,4,2,2400,0,0,2400,0
2002,BOL,Bolivia,1,76,5000,146,0,5146,100000
2002,BRA,Brazil,2,17,2000,0,1500,3500,0
2002,BGR,Bulgaria,1,1,0,0,0,0,1000
2002,BDI,Burundi,2,0,8000,0,0,8000,0
2002,KHM,Cambodia,1,29,1470000,0,0,1470000,100
2002,CAN,Canada,1,0,0,0,0,0,0
2002,SPI,"Canary Is",1,16,400,30,0,430,79923
2002,CHL,Chile,3,19,230642,0,0,230642,200000
2002,CHN,"China P Rep",10,1246,113217800,35596,2300,113255696,4728800
2002,COL,Colombia,4,65,124525,13,0,124538,0
2002,COG,Congo,1,0,5000,0,48000,53000,0
2002,CRI,"Costa Rica",2,10,95000,40,0,95040,1000
2002,CUB,Cuba,1,0,35000,0,0,35000,0
2002,CZE,"Czech Rep",1,18,200000,0,0,200000,2400000
2002,DOM,"Dominican Rep",1,3,1750,0,0,1750,500
2002,ECU,Ecuador,2,31,51600,6,3027,54633,16000
2002,EGY,Egypt,2,18,800,70,0,870,0
2002,SLV,"El Salvador",1,1,100,0,0,100,0
2002,ETH,Ethiopia,1,22,4000,0,0,4000,0
2002,FRA,France,3,23,3480,0,0,3480,1190000
2002,DEU,Germany,1,27,330000,108,0,330108,11600000
2002,GHA,Ghana,2,4,2200,0,0,2200,0
2002,GRC,Greece,4,0,390,0,0,390,0
2002,GTM,Guatemala,1,0,98740,0,0,98740,0
2002,HTI,Haiti,1,31,38335,4,0,38339,1000
2002,HND,Honduras,3,11,2545,0,144,2689,100000
2002,HUN,Hungary,1,0,1430,0,0,1430,30000
2002,IND,India,6,735,42008200,50,0,42008250,50772
2002,IDN,Indonesia,7,230,590820,750,0,591570,351600
2002,IRN,"Iran Islam Rep",3,61,200000,0,4500,204500,63060
2002,IRL,Ireland,1,0,300,0,0,300,0
2002,ITA,Italy,3,2,10000,20,0,10020,646000
2002,JAM,Jamaica,1,9,25000,0,0,25000,20000
2002,KEN,Kenya,4,85,175000,8,0,175008,0
2002,PRK,"Korea Dem P Rep",1,0,38370,436,19637,58443,0
2002,KOR,"Korea Rep",1,21,4000,7,0,4007,345000
2002,LAO,"Lao P Dem Rep",1,2,150000,0,0,150000,0
2002,MKD,"Macedonia FRY",1,0,1500,0,150,1650,0
2002,MWI,Malawi,2,9,396340,0,0,396340,0
2002,MLI,Mali,1,2,22519,0,0,22519,0
2002,MRT,Mauritania,1,25,27500,0,0,27500,0
2002,MEX,Mexico,2,37,7000,0,0,7000,0
2002,MDA,"Moldova Rep",1,1,500,0,0,500,832
2002,MAR,Morocco,1,80,15000,17,0,15017,200000
2002,MOZ,Mozambique,1,0,0,0,500,500,0
2002,MMR,Myanmar,1,21,50000,0,0,50000,0
2002,NZL,"New Zealand",1,0,300,0,0,300,500
2002,NIC,Nicaragua,1,0,10542,0,3004,13546,50
2002,NGA,Nigeria,1,0,0,0,200,200,0
2002,PAK,Pakistan,3,37,3000,10,1000,4010,30
2002,PAN,Panama,2,5,25000,0,1500,26500,500
2002,PRY,Paraguay,1,0,2765,0,0,2765,0
2002,PER,Peru,3,23,10854,14,0,10868,0
2002,PHL,Philippines,4,90,155500,67,0,155567,1842
2002,PRT,Portugal,1,1,0,0,60,60,0
2002,ROU,Romania,3,9,4800,1,3900,8701,290
2002,RUS,Russia,4,259,381913,1200,1500,384613,1007970
2002,RWA,Rwanda,1,69,20000,0,0,20000,0
2002,SAU,"Saudi Arabia",1,19,0,0,0,0,0
2002,SEN,Senegal,1,28,179000,0,0,179000,40979
2002,SCG,"Serbia Montenegro",1,0,2400,0,0,2400,0
2002,SVK,Slovakia,1,0,0,0,0,0,3000
2002,SOM,Somalia,1,0,0,0,0,0,0
2002,ZAF,"South Africa",1,16,2500,0,0,2500,0
2002,ESP,Spain,1,6,0,50,0,50,87000
2002,LKA,"Sri Lanka",1,2,500000,0,0,500000,0
2002,SDN,Sudan,1,0,100000,0,0,100000,0
2002,TJK,Tajikistan,4,32,1248,13,2990,4251,2836
2002,TZA,"Tanzania Uni Rep",1,9,1200,0,0,1200,0
2002,THA,Thailand,2,154,3290858,62,0,3290920,35827
2002,TUR,Turkey,1,34,3000,0,0,3000,0
2002,UGA,Uganda,2,17,760,0,100,860,0
2002,GBR,"United Kingdom",3,1,750,0,0,750,0
2002,USA,"United States",4,26,145750,0,0,145750,1013000
2002,URY,Uruguay,1,0,0,0,2500,2500,0
2002,VUT,Vanuatu,1,0,3000,1,0,3001,0
2002,VEN,Venezuela,1,4,55376,0,0,55376,3000
2002,VNM,"Viet Nam",3,147,1431700,116,0,1431816,84100
2002,YEM,Yemen,4,53,260,0,440,700,0
2002,COD,"Zaire/Congo Dem Rep",1,40,2500,40,0,2540,0
2003,AFG,Afghanistan,8,136,500,3,3250,3753,0
2003,DZA,Algeria,3,41,0,50,0,50,0
2003,ASM,"American Samoa",1,6,0,3,0,3,50000
2003,AGO,Angola,2,15,0,0,825,825,0
2003,ARG,Argentina,2,27,143000,0,20000,163000,1028210
2003,AUS,Australia,4,1,470,0,0,470,77000
2003,AZE,Azerbaijan,1,0,30000,0,1500,31500,55000
2003,BGD,Bangladesh,2,252,550000,0,0,550000,0
2003,BEL,Belgium,1,0,0,0,0,0,0
2003,BOL,Bolivia,3,74,47500,29,10000,57529,1000
2003,BRA,Brazil,5,255,18000,571,187410,205981,303000
2003,BFA,"Burkina Faso",1,0,0,0,12120,12120,0
2003,CAN,Canada,4,4,2470,0,0,2470,35000
2003,CAF,"Central African Rep",1,0,0,0,240,240,0
2003,CHN,"China P Rep",6,662,154368000,151260,1405726,155924986,15329640
2003,COL,Colombia,4,56,74000,59,0,74059,0
2003,CRI,"Costa Rica",1,1,2500,0,0,2500,0
2003,CUB,Cuba,1,0,600,0,0,600,0
2003,DOM,"Dominican Rep",2,10,65460,3,0,65463,44720
2003,ECU,Ecuador,1,0,7905,0,0,7905,0
2003,ERI,Eritrea,1,0,0,0,0,0,0
2003,ETH,Ethiopia,1,119,110000,0,0,110000,0
2003,FRA,France,2,10,27000,0,0,27000,1500000
2003,GRC,Greece,3,0,450,0,0,450,600000
2003,GNB,"Guinea Bissau",1,0,0,0,0,0,0
2003,HTI,Haiti,3,62,150000,70,12320,162390,0
2003,HND,Honduras,2,10,3100,5,0,3105,20000
2003,IND,India,6,452,7560000,45,4500,7564545,169000
2003,IDN,Indonesia,8,414,438398,30,0,438428,0
2003,IRN,"Iran Islam Rep",1,0,0,0,1370,1370,838
2003,ITA,Italy,2,3,1350,0,0,1350,805000
2003,JPN,Japan,1,23,800,14,0,814,7000
2003,KEN,Kenya,2,40,60300,0,0,60300,0
2003,LBN,Lebanon,1,0,17000,0,0,17000,0
2003,MKD,"Macedonia FRY",2,2,4750,0,0,4750,0
2003,MDG,Madagascar,1,16,19788,0,3582,23370,150000
2003,MWI,Malawi,2,12,18500,0,1000,19500,0
2003,MYS,Malaysia,3,8,18800,0,0,18800,0
2003,MLI,Mali,1,0,0,0,10000,10000,0
2003,MRT,Mauritania,1,9,0,0,21000,21000,0
2003,MEX,Mexico,3,6,50800,50,3000,53850,0
2003,MNG,Mongolia,1,15,1500,0,150,1650,270
2003,MAR,Morocco,1,35,10000,0,0,10000,0
2003,MOZ,Mozambique,3,38,515000,3,0,515003,0
2003,NAM,Namibia,1,2,12000,0,0,12000,0
2003,NPL,Nepal,1,239,43395,284,15575,59254,0
2003,NER,Niger,1,7,30000,0,0,30000,0
2003,NGA,Nigeria,1,16,210000,0,0,210000,2570
2003,PAK,Pakistan,3,266,1265767,476,0,1266243,0
2003,PAN,Panama,1,0,1000,0,0,1000,0
2003,PER,Peru,2,22,61500,12,3950,65462,0
2003,PHL,Philippines,1,0,3500,0,0,3500,0
2003,PRT,Portugal,1,0,36,0,0,36,0
2003,PRI,"Puerto Rico",1,2,2405,0,0,2405,0
2003,ROU,Romania,2,3,0,0,600,600,0
2003,RUS,Russia,1,0,600,0,0,600,0
2003,RWA,Rwanda,1,0,0,16,7000,7016,0
2003,SAU,"Saudi Arabia",2,12,13000,50,0,13050,0
2003,SEN,Senegal,1,8,1277,0,6492,7769,0
2003,SOM,Somalia,2,1,300,0,0,300,0
2003,ZAF,"South Africa",1,1,500,0,0,500,0
2003,LKA,"Sri Lanka",1,235,695000,0,0,695000,29000
2003,SDN,Sudan,1,20,325000,56,0,325056,184000
2003,TJK,Tajikistan,1,6,975,0,780,1755,20000
2003,TZA,"Tanzania Uni Rep",1,0,2000,0,0,2000,0
2003,THA,Thailand,3,9,107700,0,0,107700,26400
2003,TLS,Timor-Leste,2,3,1050,0,0,1050,0
2003,TUN,Tunisia,2,12,27000,0,0,27000,0
2003,TUR,Turkey,1,8,0,0,0,0,0
2003,UGA,Uganda,2,25,700,0,1500,2200,0
2003,UKR,Ukraine,1,0,600,0,0,600,0
2003,USA,"United States",4,24,3200,0,0,3200,123000
2003,URY,Uruguay,1,0,200,0,0,200,0
2003,VEN,Venezuela,2,1,450,0,200,650,0
2003,VNM,"Viet Nam",3,128,402880,63,13880,416823,105000
2003,YEM,Yemen,1,15,0,0,0,0,0
2003,COD,"Zaire/Congo Dem Rep",2,1,0,0,1481,1481,0
2003,ZMB,Zambia,2,4,0,0,11000,11000,0
2003,ZWE,Zimbabwe,1,2,18000,0,0,18000,200000
2004,AFG,Afghanistan,2,16,2800,0,1700,4500,0
2004,ALB,Albania,1,0,2500,0,0,2500,173
2004,DZA,Algeria,2,22,27545,20,0,27565,0
2004,AGO,Angola,3,28,332000,0,1700,333700,0
2004,ARG,Argentina,2,5,6300,7,0,6307,0
2004,ARM,Armenia,1,1,0,0,0,0,0
2004,AUS,Australia,3,3,3620,0,0,3620,52500
2004,BGD,Bangladesh,3,761,36871500,200,0,36871700,2200000
2004,BTN,Bhutan,1,0,0,0,0,0,0
2004,BIH,Bosnia-Hercegovenia,2,0,278000,0,0,278000,0
2004,BWA,Botswana,1,0,4960,0,0,4960,0
2004,BRA,Brazil,2,35,3000,54,2200,5254,370
2004,BDI,Burundi,1,0,0,0,10000,10000,0
2004,KHM,Cambodia,1,0,0,0,0,0,0
2004,CAN,Canada,2,0,1000,0,0,1000,200000
2004,CAF,"Central African Rep",1,3,0,0,12698,12698,0
2004,CHL,Chile,1,3,9000,0,0,9000,0
2004,CHN,"China P Rep",9,450,42702740,14526,3073,42720339,1985500
2004,COL,Colombia,2,115,531362,120,0,531482,0
2004,CRI,"Costa Rica",2,2,3056,0,0,3056,0
2004,DJI,Djibouti,1,51,98500,0,1500,100000,0
2004,DOM,"Dominican Rep",1,688,7910,0,2092,10002,0
2004,ERI,Eritrea,1,0,7000,13,0,7013,0
2004,FJI,Fiji,1,0,600,0,0,600,0
2004,GEO,Georgia,2,1,0,0,90,90,2156
2004,GNB,"Guinea Bissau",1,3,0,0,1000,1000,0
2004,HTI,Haiti,1,2665,31130,153,0,31283,0
2004,HUN,Hungary,1,0,384,0,9,393,0
2004,IND,India,6,1348,33101000,0,105000,33206000,2776000
2004,IDN,Indonesia,1,5,13000,0,0,13000,60000
2004,IRN,"Iran Islam Rep",2,40,0,53,4000,4053,0
2004,IRQ,Iraq,1,0,8000,0,0,8000,0
2004,ITA,Italy,1,2,200,0,0,200,0
2004,JPN,Japan,2,22,22290,7,5800,28097,1950000
2004,KEN,Kenya,2,54,12000,0,0,12000,0
2004,PRK,"Korea Dem P Rep",2,24,450,0,199255,199705,20000
2004,KOR,"Korea Rep",2,10,4691,0,0,4691,6595
2004,MKD,"Macedonia FRY",1,0,100000,0,0,100000,3600
2004,MYS,Malaysia,3,16,16038,0,15000,31038,10000
2004,MEX,Mexico,2,38,4050,40,0,4090,3600
2004,NAM,Namibia,2,0,25000,0,0,25000,0
2004,NPL,Nepal,1,185,800000,15,0,800015,0
2004,NZL,"New Zealand",2,4,5350,0,0,5350,245000
2004,NGA,Nigeria,5,94,29300,600,0,29900,0
2004,PAK,Pakistan,2,5,0,0,0,0,0
2004,PAN,Panama,3,16,22748,0,0,22748,0
2004,PNG,"Papua New Guinea",1,0,10000,0,0,10000,0
2004,PER,Peru,1,0,7500,0,0,7500,0
2004,PHL,Philippines,3,49,20194,0,1500,21694,0
2004,POL,Poland,1,0,600,0,0,600,0
2004,PRI,"Puerto Rico",1,0,0,0,0,0,0
2004,ROU,Romania,2,10,28128,0,0,28128,0
2004,RUS,Russia,3,18,6520,0,0,6520,56759
2004,SAU,"Saudi Arabia",1,5,400,30,0,430,0
2004,SLE,"Sierra Leone",1,10,0,0,0,0,0
2004,SVK,Slovakia,1,1,230,0,0,230,0
2004,SOM,Somalia,1,0,0,0,1500,1500,0
2004,ZAF,"South Africa",1,0,0,0,15000,15000,0
2004,ESP,Spain,1,0,600,0,0,600,14285
2004,LKA,"Sri Lanka",1,6,200000,0,0,200000,0
2004,TJK,Tajikistan,1,0,400000,0,0,400000,12000
2004,THA,Thailand,3,13,507000,0,0,507000,175000
2004,TUR,Turkey,3,23,100,0,50000,50100,0
2004,UGA,Uganda,2,0,10000,0,20000,30000,0
2004,GBR,"United Kingdom",1,0,1000,8,0,1008,96000
2004,USA,"United States",4,1,5340,0,0,5340,505500
2004,VEN,Venezuela,1,35,0,0,4000,4000,0
2004,VNM,"Viet Nam",3,96,35000,18,0,35018,8000
2004,ZMB,Zambia,1,2,196385,13,0,196398,0
2005,AFG,Afghanistan,9,295,11500,43,6775,18318,0
2005,ALB,Albania,1,3,500,0,0,500,0
2005,DZA,Algeria,2,12,70,0,1750,1820,7256
2005,AGO,Angola,1,0,0,0,10000,10000,0
2005,AUS,Australia,1,3,3000,0,0,3000,58000
2005,AUT,Austria,2,4,900,0,0,900,700000
2005,BGD,Bangladesh,3,55,1150000,0,0,1150000,0
2005,BEL,Belgium,1,0,210,0,0,210,0
2005,BIH,Bosnia-Hercegovenia,1,0,3100,0,0,3100,0
2005,BRA,Brazil,2,47,31000,0,10000,41000,0
2005,BGR,Bulgaria,5,39,12200,0,0,12200,457000
2005,BDI,Burundi,1,0,0,0,5000,5000,0
2005,KHM,Cambodia,1,16,0,0,0,0,0
2005,CMR,Cameroon,1,2,0,0,0,0,0
2005,CAN,Canada,2,4,5600,0,0,5600,357000
2005,CAF,"Central African Rep",1,1,0,7,23798,23805,0
2005,CHL,Chile,2,5,800,0,548,1348,0
2005,CHN,"China P Rep",11,578,34483742,324,268000,34752066,4660860
2005,COL,Colombia,3,180,601605,261,0,601866,10000
2005,COG,Congo,1,1,0,0,2000,2000,0
2005,CRI,"Costa Rica",2,5,2998,0,0,2998,25000
2005,HRV,Croatia,1,0,250,0,0,250,0
2005,CZE,"Czech Rep",1,1,0,0,0,0,0
2005,DOM,"Dominican Rep",1,3,1450,0,0,1450,0
2005,SLV,"El Salvador",2,48,2332,0,0,2332,0
2005,ETH,Ethiopia,4,211,242418,0,0,242418,6200
2005,FJI,Fiji,1,0,0,0,0,0,0
2005,FIN,Finland,1,0,400,0,0,400,0
2005,FRA,France,2,3,4000,0,0,4000,0
2005,GEO,Georgia,1,0,2500,0,0,2500,0
2005,DEU,Germany,2,1,450,0,0,450,220000
2005,GTM,Guatemala,1,0,0,0,0,0,0
2005,GUY,Guyana,1,34,274774,0,0,274774,465100
2005,HTI,Haiti,3,17,14078,5,0,14083,0
2005,HND,Honduras,1,8,0,0,800,800,0
2005,HKG,"Hong Kong (China)",1,0,0,0,0,0,0
2005,HUN,Hungary,2,0,0,0,0,0,48000
2005,IND,India,17,2129,28025000,71,256500,28281571,6190000
2005,IDN,Indonesia,3,154,20531,259,0,20790,0
2005,IRN,"Iran Islam Rep",4,109,3000,0,1750,4750,0
2005,JPN,Japan,1,0,900,0,0,900,0
2005,KAZ,Kazakhstan,1,0,25000,0,0,25000,7662
2005,KEN,Kenya,3,26,36200,0,0,36200,500
2005,PRK,"Korea Dem P Rep",1,193,0,205,16093,16298,0
2005,KOR,"Korea Rep",1,18,13010,0,1500,14510,0
2005,KGZ,Kyrgyzstan,1,3,0,0,2050,2050,2660
2005,LTU,Lithuania,1,0,0,0,0,0,0
2005,MKD,"Macedonia FRY",1,0,2000,0,0,2000,0
2005,MDG,Madagascar,2,29,58700,17,900,59617,0
2005,MWI,Malawi,1,1,0,0,44500,44500,0
2005,MYS,Malaysia,2,13,30600,0,0,30600,0
2005,MLI,Mali,2,0,0,0,1860,1860,0
2005,MRT,Mauritania,1,0,7500,0,0,7500,0
2005,MEX,Mexico,3,41,14000,0,0,14000,0
2005,MDA,"Moldova Rep",1,0,6500,0,0,6500,7752
2005,MOZ,Mozambique,2,16,38825,12,9000,47837,0
2005,NPL,Nepal,2,51,31600,0,0,31600,0
2005,NZL,"New Zealand",1,0,0,0,400,400,72000
2005,NGA,Nigeria,2,60,1000,4,3000,4004,147
2005,PAK,Pakistan,5,636,7523073,470,3500,7527043,30000
2005,PAN,Panama,1,3,7000,0,0,7000,7000
2005,PNG,"Papua New Guinea",1,1,2493,0,0,2493,0
2005,PHL,Philippines,2,5,193046,0,0,193046,515
2005,POL,Poland,1,2,3600,0,0,3600,0
2005,ROU,Romania,6,79,55769,2,800,56571,1313000
2005,RUS,Russia,5,22,9045,0,0,9045,23668
2005,SAU,"Saudi Arabia",2,63,50,17,0,67,0
2005,SEN,Senegal,1,0,50000,0,0,50000,0
2005,SCG,"Serbia Montenegro",1,2,1945,0,1845,3790,0
2005,SLE,"Sierra Leone",1,20,15000,0,0,15000,0
2005,SVK,Slovakia,1,1,0,0,0,0,0
2005,SVN,Slovenia,1,0,0,0,0,0,5000
2005,SOM,Somalia,2,12,5000,20,2500,7520,20
2005,LKA,"Sri Lanka",1,6,145000,0,0,145000,0
2005,SDN,Sudan,2,5,156000,0,4780,160780,0
2005,CHE,Switzerland,1,6,2500,0,0,2500,2100000
2005,TWN,"Taiwan (China)",1,16,2700,0,0,2700,62000
2005,TJK,Tajikistan,2,8,4767,0,345,5112,50000
2005,TZA,"Tanzania Uni Rep",1,1,10548,0,0,10548,0
2005,THA,Thailand,2,76,819270,40,0,819310,218000
2005,TUR,Turkey,2,7,3000,0,0,3000,0
2005,UKR,Ukraine,1,0,8340,0,0,8340,0
2005,USA,"United States",6,53,18250,8,0,18258,730330
2005,UZB,Uzbekistan,1,0,1500,0,0,1500,0
2005,VEN,Venezuela,4,97,44000,147,1650,45797,51000
2005,VNM,"Viet Nam",5,192,74185,3,18205,92393,54000
2005,YEM,Yemen,2,22,215,6,500,721,0
2005,ZMB,Zambia,1,0,4000,0,0,4000,0
2006,AFG,Afghanistan,7,282,24775,185,8015,32975,0
2006,DZA,Algeria,1,1,60000,0,0,60000,1200
2006,AGO,Angola,1,0,0,0,225,225,0
2006,ARG,Argentina,1,0,4500,0,0,4500,0
2006,AUS,Australia,1,0,1100,0,0,1100,0
2006,AUT,Austria,1,0,516,0,0,516,0
2006,BGD,Bangladesh,2,0,211775,0,0,211775,0
2006,BOL,Bolivia,2,25,126550,50,0,126600,35000
2006,BRA,Brazil,2,20,116000,0,0,116000,0
2006,BGR,Bulgaria,2,0,0,0,0,0,0
2006,BFA,"Burkina Faso",2,0,15610,0,10000,25610,0
2006,BDI,Burundi,6,22,7000,0,7805,14805,0
2006,KHM,Cambodia,2,5,38000,0,0,38000,0
2006,CAN,Canada,5,1,3900,0,0,3900,0
2006,TCD,Chad,1,52,0,0,0,0,0
2006,CHL,Chile,1,18,95862,0,0,95862,0
2006,CHN,"China P Rep",20,430,14610500,549,379000,14990049,1687500
2006,COL,Colombia,1,150,221238,227,0,221465,0
2006,COG,Congo,1,6,0,0,5000,5000,0
2006,HRV,Croatia,1,0,0,0,0,0,0
2006,CUB,Cuba,1,2,1500,0,0,1500,0
2006,CZE,"Czech Rep",2,6,4315,0,0,4315,0
2006,ECU,Ecuador,1,16,57670,0,0,57670,2800
2006,ETH,Ethiopia,7,951,434050,96,0,434146,3200
2006,FJI,Fiji,1,4,224,0,0,224,500
2006,GEO,Georgia,1,0,600,0,0,600,0
2006,DEU,Germany,1,0,1000,0,0,1000,0
2006,GRC,Greece,2,1,3090,0,0,3090,5659
2006,GIN,Guinea,1,0,1200,0,0,1200,0
2006,GUY,Guyana,1,0,35000,0,0,35000,169000
2006,HTI,Haiti,2,11,24690,10,0,24700,0
2006,HND,Honduras,1,4,1500,0,0,1500,8000
2006,HUN,Hungary,1,0,32000,0,0,32000,0
2006,IND,India,17,1194,3234000,178,4000000,7234178,3390000
2006,IDN,Indonesia,8,645,698141,97,670,698908,107300
2006,IRN,"Iran Islam Rep",1,14,2800,0,0,2800,16000
2006,IRQ,Iraq,2,20,59890,20,0,59910,1300
2006,JAM,Jamaica,1,1,5000,0,0,5000,0
2006,JPN,Japan,2,42,10500,32,0,10532,0
2006,KEN,Kenya,4,212,783300,0,0,783300,0
2006,PRK,"Korea Dem P Rep",2,278,7310,14,84500,91824,0
2006,KOR,"Korea Rep",1,46,4630,0,0,4630,0
2006,MKD,"Macedonia FRY",1,0,1500,0,0,1500,0
2006,MWI,Malawi,2,8,0,0,16000,16000,0
2006,MYS,Malaysia,4,6,106518,0,0,106518,22000
2006,MLI,Mali,1,1,0,0,1000,1000,0
2006,MRT,Mauritania,2,7,0,19,10600,10619,0
2006,MEX,Mexico,1,0,0,0,0,0,0
2006,MAR,Morocco,3,17,2100,0,0,2100,0
2006,MMR,Myanmar,1,25,10000,0,0,10000,0
2006,NAM,Namibia,2,5,2300,0,0,2300,8490
2006,NPL,Nepal,1,0,0,0,0,0,0
2006,NZL,"New Zealand",1,0,1200,0,0,1200,3000
2006,NER,Niger,1,4,0,0,46472,46472,0
2006,NGA,Nigeria,3,40,3000,0,10000,13000,0
2006,PAK,Pakistan,7,400,2000,525,5600,8125,0
2006,PAN,Panama,2,11,5140,0,1290,6430,0
2006,PNG,"Papua New Guinea",2,1,400,0,12000,12400,0
2006,PER,Peru,1,0,15000,0,325,15325,0
2006,PHL,Philippines,6,36,732509,0,0,732509,14157
2006,POL,Poland,1,0,500,0,0,500,0
2006,PRT,Portugal,1,0,240,0,0,240,0
2006,ROU,Romania,6,51,19581,2,5000,24583,0
2006,RUS,Russia,3,0,7720,0,0,7720,132411
2006,SCG,"Serbia Montenegro",2,0,36200,0,0,36200,0
2006,SVK,Slovakia,2,1,100,0,0,100,0
2006,SOM,Somalia,5,102,486500,0,0,486500,0
2006,ZAF,"South Africa",2,12,7160,0,0,7160,216000
2006,ESP,Spain,1,0,0,0,0,0,0
2006,LKA,"Sri Lanka",1,25,333000,2,0,333002,3000
2006,SDN,Sudan,3,27,161000,0,6000,167000,0
2006,SUR,Suriname,1,3,25000,0,0,25000,0
2006,CHE,Switzerland,1,0,3000,0,0,3000,0
2006,SYR,"Syrian Arab Rep",1,6,0,0,0,0,0
2006,TWN,"Taiwan (China)",1,3,300,0,0,300,116130
2006,TZA,"Tanzania Uni Rep",2,0,0,28,21500,21528,0
2006,THA,Thailand,3,280,2557308,0,0,2557308,34940
2006,TGO,Togo,1,0,2000,0,0,2000,0
2006,TUR,Turkey,2,59,63000,15,0,63015,317000
2006,UGA,Uganda,2,3,5680,0,0,5680,0
2006,UKR,Ukraine,2,2,5000,0,0,5000,23855
2006,USA,"United States",11,40,74050,10,0,74060,1478500
2006,VEN,Venezuela,1,0,95,0,40,135,0
2006,VNM,"Viet Nam",5,178,50000,120,2000,52120,9000
2006,YEM,Yemen,2,30,0,20,2300,2320,0
2006,COD,"Zaire/Congo Dem Rep",3,1,9370,0,3600,12970,0
2007,AFG,Afghanistan,7,296,26755,20,3480,30255,0
2007,DZA,Algeria,6,82,1300,5,0,1305,43061
2007,AGO,Angola,2,105,40000,0,6000,46000,0
2007,ARG,Argentina,2,10,130000,0,5000,135000,40000
2007,AUS,Australia,1,9,5000,0,0,5000,1300000
2007,BGD,Bangladesh,2,1230,13851380,60,0,13851440,114000
2007,BEN,Benin,1,10,10000,0,884,10884,0
2007,BOL,Bolivia,2,115,824495,0,0,824495,590000
2007,BRA,Brazil,3,69,206272,80,0,206352,125000
2007,BGR,Bulgaria,3,12,1060,10,0,1070,0
2007,BFA,"Burkina Faso",1,52,92970,73,28000,121043,0
2007,BDI,Burundi,2,5,2695,6,23000,25701,0
2007,KHM,Cambodia,1,2,19000,0,0,19000,1000
2007,CMR,Cameroon,1,8,0,17,10279,10296,0
2007,CAN,Canada,1,0,500,0,0,500,0
2007,CAF,"Central African Rep",1,1,6000,0,1812,7812,0
2007,TCD,Chad,2,15,173000,0,0,173000,0
2007,CHN,"China P Rep",12,1030,111041600,4192,65000,111110792,5023155
2007,COL,Colombia,4,218,1608083,260,2000,1610343,0
2007,COG,Congo,1,0,20000,0,5000,25000,0
2007,CRI,"Costa Rica",2,19,24500,0,0,24500,80000
2007,CIV,"Cote d'Ivoire",1,0,2000,0,0,2000,0
2007,CUB,Cuba,1,0,18000,0,0,18000,0
2007,DOM,"Dominican Rep",2,12,19830,0,0,19830,0
2007,SLV,"El Salvador",1,2,500,0,0,500,0
2007,ETH,Ethiopia,2,17,245386,0,0,245386,0
2007,FJI,Fiji,2,6,900,0,0,900,37000
2007,GMB,"Gambia The",1,0,300,0,0,300,0
2007,DEU,Germany,1,1,0,0,0,0,0
2007,GHA,Ghana,1,56,332600,0,0,332600,0
2007,GRC,Greece,1,2,600,0,0,600,0
2007,GTM,Guatemala,2,11,2096,0,0,2096,0
2007,GIN,Guinea,1,0,20685,0,0,20685,0
2007,HTI,Haiti,4,61,89020,92,15849,104961,0
2007,HND,Honduras,2,6,15500,0,0,15500,0
2007,IND,India,16,2051,38143000,8,0,38143008,376151
2007,IDN,Indonesia,8,438,559538,134,9875,569547,971000
2007,IRN,"Iran Islam Rep",1,12,0,0,0,0,22000
2007,JPN,Japan,1,2,10000,0,0,10000,0
2007,KEN,Kenya,3,19,42650,1,0,42651,0
2007,PRK,"Korea Dem P Rep",1,610,1000000,518,170000,1170518,300000
2007,KOR,"Korea Rep",1,3,1000,0,0,1000,0
2007,KGZ,Kyrgyzstan,1,0,845,0,0,845,200
2007,LBR,Liberia,1,1,17000,0,0,17000,0
2007,MDG,Madagascar,1,7,33000,0,0,33000,0
2007,MWI,Malawi,4,2,199306,0,2659,201965,0
2007,MYS,Malaysia,2,46,137533,0,29000,166533,968000
2007,MDV,Maldives,1,0,1649,0,0,1649,0
2007,MLI,Mali,1,9,42662,17,4576,47255,0
2007,MRT,Mauritania,2,3,54120,0,0,54120,0
2007,MEX,Mexico,2,22,1655000,0,0,1655000,3000000
2007,MNE,Montenegro,1,0,1086,0,0,1086,0
2007,MOZ,Mozambique,4,54,398535,0,3500,402035,171000
2007,MMR,Myanmar,4,5,162317,110,4237,166664,0
2007,NAM,Namibia,1,7,15000,0,0,15000,0
2007,NPL,Nepal,1,214,640658,48,0,640706,2400
2007,NIC,Nicaragua,1,10,24000,0,0,24000,0
2007,NER,Niger,1,7,57264,10,0,57274,0
2007,NGA,Nigeria,3,91,55000,0,0,55000,0
2007,PAK,Pakistan,6,526,2500,206,0,2706,327118
2007,PAN,Panama,1,2,129,0,0,129,0
2007,PER,Peru,1,17,47703,11,0,47714,0
2007,PHL,Philippines,5,40,86747,0,0,86747,6600
2007,ROU,Romania,4,12,4260,0,0,4260,0
2007,RUS,Russia,1,0,14000,0,0,14000,25752
2007,RWA,Rwanda,2,30,4500,0,0,4500,9
2007,SEN,Senegal,1,8,5300,0,0,5300,0
2007,SRB,Serbia,1,0,12370,0,0,12370,0
2007,SLE,"Sierra Leone",1,0,4500,0,0,4500,0
2007,SOM,Somalia,2,25,8000,12,2000,10012,0
2007,ZAF,"South Africa",1,0,38000,0,0,38000,0
2007,ESP,Spain,3,5,4430,0,0,4430,400000
2007,LKA,"Sri Lanka",3,33,406000,0,0,406000,50
2007,SDN,Sudan,1,150,365000,335,200000,565335,300000
2007,CHE,Switzerland,1,1,100,1,0,101,350000
2007,TJK,Tajikistan,2,22,17184,0,125,17309,0
2007,THA,Thailand,5,53,183000,0,0,183000,1500
2007,TLS,Timor-Leste,2,1,947,0,0,947,0
2007,TGO,Togo,1,41,127880,77,13374,141331,0
2007,TUN,Tunisia,2,16,6500,0,0,6500,0
2007,TUR,Turkey,3,16,3150,0,36,3186,0
2007,UGA,Uganda,2,33,438070,0,282975,721045,71
2007,GBR,"United Kingdom",3,14,340200,0,30000,370200,8448000
2007,USA,"United States",6,80,8770,40,0,8810,728000
2007,URY,Uruguay,2,2,110000,0,10000,120000,45000
2007,VNM,"Viet Nam",5,230,962000,172,0,962172,790000
2007,YEM,Yemen,3,93,2600,18,0,2618,0
2007,COD,"Zaire/Congo Dem Rep",1,32,1500,100,0,1600,0
2007,ZMB,Zambia,3,14,1553521,0,0,1553521,0
2007,ZWE,Zimbabwe,2,27,17000,0,0,17000,0
2008,AFG,Afghanistan,1,0,1000,0,180,1180,0
2008,DZA,Algeria,1,93,59000,50,0,59050,348000
2008,AGO,Angola,1,7,81400,0,0,81400,0
2008,ARG,Argentina,1,0,85000,0,0,85000,0
2008,AUS,Australia,4,7,8400,0,0,8400,2065000
2008,BGD,Bangladesh,2,28,600000,2,35638,635640,0
2008,BLZ,Belize,1,1,38000,0,0,38000,9697
2008,BEN,Benin,1,15,158235,0,0,158235,0
2008,BRA,Brazil,4,200,1750929,27,1435,1752391,1013000
2008,BFA,"Burkina Faso",2,6,560,18,4292,4870,0
2008,BDI,Burundi,2,9,3270,5,0,3275,0
2008,CMR,Cameroon,1,9,24000,0,1000,25000,0
2008,CAN,Canada,2,0,2400,0,0,2400,0
2008,CAF,"Central African Rep",1,0,0,0,795,795,0
2008,TCD,Chad,2,0,8000,0,6450,14450,0
2008,CHL,Chile,2,9,121755,0,23000,144755,23000
2008,CHN,"China P Rep",7,352,7189000,166,0,7189166,2392000
2008,COL,Colombia,3,89,1250000,91,0,1250091,0
2008,CRI,"Costa Rica",3,7,154498,0,0,154498,0
2008,CIV,"Cote d'Ivoire",1,6,450,0,0,450,0
2008,CUB,Cuba,1,0,20000,0,0,20000,0
2008,ECU,Ecuador,1,41,275000,0,14122,289122,1000000
2008,SLV,"El Salvador",2,30,3000,0,0,3000,0
2008,ETH,Ethiopia,3,45,115595,35,810,116440,0
2008,GMB,"Gambia The",1,0,0,0,400,400,0
2008,GHA,Ghana,1,0,58000,0,0,58000,0
2008,GTM,Guatemala,2,30,197300,0,0,197300,0
2008,GIN,Guinea,1,0,4200,0,0,4200,0
2008,GNB,"Guinea Bissau",1,0,0,0,750,750,0
2008,GUY,Guyana,1,0,100000,0,0,100000,0
2008,HND,Honduras,1,67,313350,7,0,313357,0
2008,IND,India,8,1590,11589018,0,2400000,13989018,145000
2008,IDN,Indonesia,12,112,473275,0,2920,476195,1733
2008,IRN,"Iran Islam Rep",2,22,1400,80,0,1480,0
2008,IRQ,Iraq,1,4,0,0,600,600,0
2008,ITA,Italy,3,9,300,0,0,300,278000
2008,JPN,Japan,1,5,50000,3,0,50003,0
2008,KAZ,Kazakhstan,1,1,13000,0,0,13000,130000
2008,KEN,Kenya,6,55,62438,0,0,62438,0
2008,KIR,Kiribati,1,0,0,0,85,85,0
2008,KOR,"Korea Rep",1,10,0,13,0,13,0
2008,LAO,"Lao P Dem Rep",1,6,204190,0,0,204190,0
2008,LBR,Liberia,1,0,0,0,340,340,0
2008,MWI,Malawi,1,0,16380,0,0,16380,0
2008,MYS,Malaysia,2,0,8000,0,0,8000,0
2008,MLI,Mali,1,0,0,0,2500,2500,0
2008,MHL,"Marshall Is",1,0,600,0,0,600,0
2008,MEX,Mexico,1,12,20000,0,0,20000,0
2008,FSM,"Micronesia Fed States",1,0,0,0,0,0,0
2008,MDA,"Moldova Rep",1,3,4000,0,0,4000,0
2008,MAR,Morocco,2,39,20000,0,0,20000,0
2008,MOZ,Mozambique,1,25,3500,0,0,3500,0
2008,NAM,Namibia,1,42,65000,0,0,65000,0
2008,NPL,Nepal,2,115,250000,3,0,250003,29
2008,NIC,Nicaragua,2,17,14188,0,0,14188,0
2008,NER,Niger,1,7,32000,0,0,32000,0
2008,PAK,Pakistan,3,83,290752,12,0,290764,103000
2008,PSE,"Palestine (West Bank)",1,0,0,0,0,0,0
2008,PAN,Panama,2,28,23832,5,0,23837,10000
2008,PNG,"Papua New Guinea",1,0,75300,0,0,75300,0
2008,PER,Peru,1,40,450000,12,0,450012,0
2008,PHL,Philippines,8,116,1552848,41,50000,1602889,39577
2008,PRT,Portugal,1,2,72,0,38,110,0
2008,ROU,Romania,1,5,11000,0,0,11000,0
2008,RWA,Rwanda,1,0,11295,51,0,11346,0
2008,SEN,Senegal,1,1,23600,0,0,23600,0
2008,SLB,"Solomon Is",1,0,0,0,0,0,0
2008,SOM,Somalia,1,0,52000,0,0,52000,0
2008,ZAF,"South Africa",1,11,4000,0,0,4000,1264
2008,LKA,"Sri Lanka",3,48,776905,0,0,776905,0
2008,SDN,Sudan,3,17,92791,0,0,92791,0
2008,SUR,Suriname,1,2,6548,0,0,6548,0
2008,SWZ,Swaziland,1,0,2500,0,0,2500,0
2008,TZA,"Tanzania Uni Rep",2,73,7500,15,1942,9457,0
2008,THA,Thailand,3,39,1572157,0,0,1572157,27844
2008,TGO,Togo,1,6,44735,79,0,44814,0
2008,UGA,Uganda,1,49,30000,40,0,30040,0
2008,UKR,Ukraine,1,38,224725,0,0,224725,1000000
2008,GBR,"United Kingdom",2,8,3300,0,0,3300,3000
2008,USA,"United States",4,44,11032500,148,0,11032648,10002000
2008,VEN,Venezuela,1,8,1500,0,0,1500,0
2008,VNM,"Viet Nam",5,157,632500,4,0,632504,483000
2008,YEM,Yemen,1,90,25000,64,0,25064,400000
2008,COD,"Zaire/Congo Dem Rep",1,15,0,2,500,502,0
2008,ZMB,Zambia,1,4,15000,0,0,15000,0
2009,AFG,Afghanistan,3,69,62500,16,0,62516,20000
2009,ALB,Albania,1,0,6600,0,0,6600,0
2009,DZA,Algeria,2,48,0,48,2500,2548,0
2009,AGO,Angola,3,62,220000,0,5065,225065,0
2009,ARG,Argentina,2,9,34128,0,0,34128,0
2009,AUS,Australia,2,7,9200,0,0,9200,150000
2009,AUT,Austria,2,1,0,0,0,0,200000
2009,AZE,Azerbaijan,1,0,5000,0,0,5000,0
2009,BGD,Bangladesh,2,16,500000,0,0,500000,0
2009,BEN,Benin,2,10,119657,0,0,119657,0
2009,BOL,Bolivia,1,0,63000,0,0,63000,0
2009,BIH,Bosnia-Hercegovenia,2,0,3730,0,0,3730,0
2009,BWA,Botswana,2,0,4656,0,0,4656,0
2009,BRA,Brazil,7,76,1849948,0,2500,1852448,550000
2009,BFA,"Burkina Faso",2,9,150500,1000,0,151500,150000
2009,BDI,Burundi,1,0,8000,0,0,8000,0
2009,CAN,Canada,1,0,200,0,0,200,0
2009,CPV,"Cape Verde Is",1,3,150,0,0,150,0
2009,CAF,"Central African Rep",1,1,0,0,11000,11000,0
2009,TCD,Chad,2,6,7120,0,5795,12915,0
2009,CHN,"China P Rep",7,209,45226000,38,0,45226038,1373000
2009,COL,Colombia,1,23,31250,0,0,31250,0
2009,COM,Comoros,1,2,2500,0,0,2500,0
2009,CZE,"Czech Rep",1,13,14450,0,0,14450,150000
2009,DOM,"Dominican Rep",2,7,14565,0,0,14565,52403
2009,ECU,Ecuador,1,3,11805,2,0,11807,0
2009,FJI,Fiji,1,12,10556,0,0,10556,43247
2009,GMB,"Gambia The",1,5,14258,0,0,14258,0
2009,DEU,Germany,1,0,0,0,0,0,20000
2009,GHA,Ghana,2,40,159545,0,0,159545,0
2009,GTM,Guatemala,1,0,10800,0,0,10800,0
2009,GIN,Guinea,1,2,40000,0,0,40000,0
2009,HTI,Haiti,3,21,2796,0,9910,12706,0
2009,IND,India,6,1500,5986000,8,0,5986008,2434000
2009,IDN,Indonesia,5,126,26800,4,0,26804,0
2009,IRQ,Iraq,1,2,3000,0,0,3000,0
2009,IRL,Ireland,1,0,0,0,0,0,0
2009,ITA,Italy,1,35,0,140,5000,5140,20000
2009,KEN,Kenya,2,56,136200,0,0,136200,0
2009,LAO,"Lao P Dem Rep",1,10,0,0,0,0,0
2009,LBR,Liberia,1,2,584,0,0,584,0
2009,MYS,Malaysia,2,0,10875,0,0,10875,0
2009,MLI,Mali,1,25,20390,16,0,20406,0
2009,MRT,Mauritania,1,1,10000,0,0,10000,0
2009,MEX,Mexico,5,28,140170,14,0,140184,0
2009,MNG,Mongolia,1,26,15000,0,0,15000,94
2009,MNE,Montenegro,1,0,450,0,0,450,0
2009,MAR,Morocco,2,29,9500,20,0,9520,0
2009,MOZ,Mozambique,1,0,6925,0,0,6925,0
2009,NAM,Namibia,1,92,350000,0,0,350000,0
2009,NPL,Nepal,2,117,257724,62,0,257786,60000
2009,NIC,Nicaragua,2,0,6885,0,0,6885,0
2009,NER,Niger,1,3,79129,0,0,79129,0
2009,NGA,Nigeria,2,31,150000,0,0,150000,0
2009,PAK,Pakistan,3,102,75000,80,0,75080,0
2009,PAN,Panama,1,0,4248,0,0,4248,0
2009,PRY,Paraguay,1,0,12035,0,0,12035,820
2009,PER,Peru,1,158,235886,422,0,236308,0
2009,PHL,Philippines,8,55,1083261,15,0,1083276,29314
2009,POL,Poland,1,1,150,0,0,150,100000
2009,ROU,Romania,2,11,0,4,0,4,0
2009,SAU,"Saudi Arabia",1,161,0,0,10000,10000,900000
2009,SEN,Senegal,1,6,264000,0,0,264000,0
2009,SRB,Serbia,1,0,3210,0,0,3210,0
2009,SLE,"Sierra Leone",1,103,1455,15,0,1470,0
2009,SLB,"Solomon Is",1,21,7000,0,0,7000,0
2009,SOM,Somalia,1,0,1750,0,0,1750,0
2009,ZAF,"South Africa",2,14,20300,0,0,20300,0
2009,LKA,"Sri Lanka",3,3,320000,0,60000,380000,0
2009,SDN,Sudan,1,20,111455,0,0,111455,0
2009,TJK,Tajikistan,1,21,15000,0,0,15000,1000
2009,TZA,"Tanzania Uni Rep",2,38,50000,0,0,50000,0
2009,THA,Thailand,1,15,200000,0,0,200000,0
2009,TGO,Togo,1,0,0,0,0,0,0
2009,TUN,Tunisia,1,17,0,8,0,8,0
2009,TUR,Turkey,2,47,35100,31,0,35131,550000
2009,GBR,"United Kingdom",1,3,3900,0,0,3900,484000
2009,USA,"United States",4,11,9000,60,900,9960,666000
2009,URY,Uruguay,1,1,4000,0,0,4000,0
2009,VUT,Vanuatu,1,0,950,0,0,950,0
2009,VNM,"Viet Nam",2,37,740000,0,0,740000,0
2009,COD,"Zaire/Congo Dem Rep",1,0,5000,0,0,5000,0
2009,ZMB,Zambia,1,31,614814,0,0,614814,0
2010,AFG,Afghanistan,2,135,45000,0,0,45000,0
2010,ALB,Albania,1,0,14000,0,0,14000,0
2010,AGO,Angola,3,25,110875,31,78875,189781,0
2010,AUS,Australia,5,35,186000,0,0,186000,7409000
2010,AZE,Azerbaijan,1,3,70000,0,0,70000,0
2010,BGD,Bangladesh,2,15,575000,0,0,575000,0
2010,BEL,Belgium,1,3,690,0,0,690,238146
2010,BEN,Benin,1,46,680000,1000,150000,831000,0
2010,BOL,Bolivia,1,26,227860,0,0,227860,0
2010,BIH,Bosnia-Hercegovenia,2,3,34910,0,0,34910,87000
2010,BRA,Brazil,3,363,231535,403,13000,244938,802000
2010,BGR,Bulgaria,1,0,90,0,0,90,0
2010,BFA,"Burkina Faso",1,16,133362,0,0,133362,176
2010,BDI,Burundi,2,0,1990,0,0,1990,0
2010,KHM,Cambodia,1,8,0,0,0,0,70000
2010,CMR,Cameroon,1,13,0,95,3000,3095,0
2010,CAF,"Central African Rep",1,3,1585,0,0,1585,0
2010,TCD,Chad,1,24,144579,0,0,144579,0
2010,CHN,"China P Rep",5,1911,140194000,0,0,140194000,18171000
2010,COL,Colombia,3,418,2796097,463,0,2796560,1000000
2010,CRI,"Costa Rica",2,27,3106,0,0,3106,0
2010,CIV,"Cote d'Ivoire",2,18,6425,0,0,6425,0
2010,HRV,Croatia,2,0,1110,0,0,1110,80000
2010,CZE,"Czech Rep",3,11,1400,0,0,1400,347560
2010,DOM,"Dominican Rep",2,7,35200,0,0,35200,0
2010,ECU,Ecuador,2,14,6440,0,500,6940,0
2010,EGY,Egypt,2,27,3500,0,0,3500,0
2010,ETH,Ethiopia,2,19,80700,0,0,80700,0
2010,FRA,France,1,25,0,0,0,0,1500000
2010,GMB,"Gambia The",2,9,38961,0,0,38961,0
2010,DEU,Germany,1,3,0,0,0,0,0
2010,GHA,Ghana,2,63,17174,0,0,17174,0
2010,GRC,Greece,1,1,150,0,0,150,0
2010,GTM,Guatemala,1,0,3270,0,0,3270,0
2010,GIN,Guinea,2,8,48020,6,0,48026,0
2010,GNB,"Guinea Bissau",1,2,56792,0,0,56792,0
2010,HTI,Haiti,3,44,22085,2,0,22087,0
2010,HND,Honduras,2,122,5000,10,0,5010,0
2010,HUN,Hungary,1,1,2000,0,0,2000,440000
2010,IND,India,9,788,3895183,225,400000,4295408,2149000
2010,IDN,Indonesia,7,411,52936,3424,230,56590,78000
2010,ISR,Israel,1,2,0,0,0,0,0
2010,ITA,Italy,1,0,300,0,0,300,0
2010,JPN,Japan,1,10,0,0,0,0,0
2010,KAZ,Kazakhstan,2,44,23500,700,5000,29200,34576
2010,KEN,Kenya,2,194,211164,0,0,211164,0
2010,PRK,"Korea Dem P Rep",2,0,55785,0,0,55785,0
2010,LBR,Liberia,1,1,15486,0,0,15486,0
2010,LTU,Lithuania,1,4,0,0,0,0,0
2010,MWI,Malawi,1,0,21290,0,0,21290,0
2010,MLI,Mali,2,0,32000,0,0,32000,0
2010,MRT,Mauritania,1,0,8750,0,0,8750,0
2010,MEX,Mexico,2,66,1020000,0,0,1020000,16000
2010,MDA,"Moldova Rep",1,1,12000,0,0,12000,0
2010,MNE,Montenegro,2,0,6350,0,0,6350,0
2010,MAR,Morocco,2,42,77000,9,0,77009,29000
2010,MOZ,Mozambique,1,5,17000,0,0,17000,0
2010,NAM,Namibia,1,8,110000,0,0,110000,0
2010,NPL,Nepal,2,150,8000,0,0,8000,0
2010,NIC,Nicaragua,2,66,75860,0,0,75860,0
2010,NER,Niger,2,5,226611,0,6615,233226,0
2010,NGA,Nigeria,1,40,1500000,200,0,1500200,30000
2010,PAK,Pakistan,4,2113,20360550,2946,0,20363496,9500000
2010,PSE,"Palestine (West Bank)",1,0,0,0,500,500,0
2010,PAN,Panama,4,15,32642,299,0,32941,0
2010,PER,Peru,1,20,80000,0,0,80000,0
2010,PHL,Philippines,9,162,2846913,22,0,2846935,50589
2010,POL,Poland,2,19,100700,0,0,100700,3080000
2010,PRT,Portugal,1,43,600,18,0,618,1350000
2010,ROU,Romania,1,26,12237,0,0,12237,1111428
2010,RUS,Russia,2,23,48464,0,0,48464,66000
2010,SAU,"Saudi Arabia",2,24,85,0,0,85,0
2010,SEN,Senegal,2,2,102453,63,0,102516,0
2010,SRB,Serbia,3,2,4900,0,0,4900,0
2010,SLE,"Sierra Leone",1,0,234,0,0,234,0
2010,SVK,Slovakia,2,4,850,0,0,850,25000
2010,SLB,"Solomon Is",1,2,16016,1,0,16017,0
2010,SOM,Somalia,2,11,16000,0,200,16200,0
2010,ESP,Spain,1,2,30,0,0,30,0
2010,LKA,"Sri Lanka",2,35,770255,10,0,770265,105000
2010,LCA,"St Lucia",1,0,2000,0,0,2000,0
2010,SDN,Sudan,3,36,306350,12,10000,316362,0
2010,TJK,Tajikistan,2,75,8322,300,0,8622,204000
2010,THA,Thailand,1,258,8970653,0,0,8970653,332000
2010,TGO,Togo,2,22,111550,0,0,111550,0
2010,UKR,Ukraine,1,6,40000,59,0,40059,1900
2010,USA,"United States",3,20,1000,0,0,1000,0
2010,VEN,Venezuela,1,41,94800,0,0,94800,170000
2010,VNM,"Viet Nam",4,186,1489750,83,0,1489833,660200
2010,YEM,Yemen,2,22,0,2,1000,1002,0
2010,COD,"Zaire/Congo Dem Rep",2,0,68700,0,1800,70500,0
2010,ZMB,Zambia,1,0,1200,0,0,1200,0
2010,ZWE,Zimbabwe,1,0,820,0,0,820,0
2011,AFG,Afghanistan,2,62,3000,110,9700,12810,0
2011,DZA,Algeria,1,10,750,43,0,793,779000
2011,AGO,Angola,4,130,90584,0,100,90684,0
2011,AUS,Australia,1,0,217,0,0,217,0
2011,BGD,Bangladesh,1,10,1570559,0,0,1570559,0
2011,BEL,Belgium,1,0,0,0,0,0,0
2011,BEN,Benin,1,0,5840,0,0,5840,0
2011,BOL,Bolivia,1,52,88825,0,0,88825,20000
2011,BWA,Botswana,1,0,0,0,0,0,0
2011,BRA,Brazil,8,978,1185600,0,30000,1215600,1000000
2011,BDI,Burundi,1,0,685,0,0,685,0
2011,KHM,Cambodia,1,247,1640000,23,0,1640023,521000
2011,CAN,Canada,1,5,2000,0,0,2000,800000
2011,CAF,"Central African Rep",1,0,2935,0,0,2935,0
2011,CHN,"China P Rep",5,628,93360000,0,0,93360000,10704130
2011,COL,Colombia,2,273,1487261,262,0,1487523,2320000
2011,CRI,"Costa Rica",1,4,46695,0,0,46695,0
2011,DOM,"Dominican Rep",1,4,11200,0,0,11200,0
2011,ECU,Ecuador,1,0,3600,0,0,3600,0
2011,SLV,"El Salvador",1,35,300000,0,0,300000,1000000
2011,ETH,Ethiopia,1,0,40200,0,0,40200,0
2011,FRA,France,1,3,2300,0,0,2300,0
2011,GEO,Georgia,1,7,1750,0,0,1750,0
2011,DEU,Germany,1,4,0,0,0,0,0
2011,GHA,Ghana,2,20,94032,12,0,94044,0
2011,GTM,Guatemala,3,59,534810,18,0,534828,61913
2011,GIN,Guinea,1,0,16143,0,4000,20143,0
2011,HTI,Haiti,2,36,4430,8,0,4438,0
2011,HND,Honduras,1,33,69798,0,0,69798,0
2011,IND,India,7,608,12004069,0,0,12004069,1657000
2011,IDN,Indonesia,6,62,15864,0,4000,19864,0
2011,IRQ,Iraq,1,6,0,1,2000,2001,0
2011,IRL,Ireland,1,2,600,0,0,600,325000
2011,ITA,Italy,2,16,0,0,0,0,545000
2011,KAZ,Kazakhstan,1,2,12238,0,3762,16000,67000
2011,KEN,Kenya,3,33,95692,0,5000,100692,0
2011,PRK,"Korea Dem P Rep",2,64,51093,0,0,51093,0
2011,KOR,"Korea Rep",2,62,29000,0,0,29000,52000
2011,LAO,"Lao P Dem Rep",2,48,467000,0,0,467000,0
2011,LSO,Lesotho,2,26,5000,0,0,5000,0
2011,MWI,Malawi,3,4,83586,1,0,83587,0
2011,MYS,Malaysia,1,2,20000,0,0,20000,0
2011,MLI,Mali,1,1,15415,0,0,15415,0
2011,MEX,Mexico,3,77,440000,0,40000,480000,0
2011,MOZ,Mozambique,2,11,63946,0,0,63946,0
2011,MMR,Myanmar,1,151,35734,0,0,35734,1700
2011,NAM,Namibia,1,108,500000,0,0,500000,12000
2011,NPL,Nepal,2,104,1826,32,0,1858,0
2011,NIC,Nicaragua,1,17,143000,18,0,143018,0
2011,NER,Niger,2,16,13000,0,28175,41175,0
2011,NGA,Nigeria,4,174,30265,150,500,30915,4500
2011,PAK,Pakistan,1,509,5400000,755,0,5400755,2500000
2011,PAN,Panama,2,0,4000,0,0,4000,0
2011,PER,Peru,3,72,822838,107,0,822945,0
2011,PHL,Philippines,15,122,2218638,190,0,2218828,202787
2011,RUS,Russia,2,0,14169,0,0,14169,21015
2011,RWA,Rwanda,1,14,3588,20,0,3608,0
2011,SAU,"Saudi Arabia",1,11,0,0,0,0,300000
2011,SEN,Senegal,1,0,5214,6,0,5220,0
2011,SLE,"Sierra Leone",1,21,0,0,0,0,0
2011,SOM,Somalia,1,0,2800,0,0,2800,0
2011,ZAF,"South Africa",1,40,200000,321,0,200321,211000
2011,ESP,Spain,1,1,2400,0,0,2400,0
2011,LKA,"Sri Lanka",3,65,233600,51,1060273,1293924,500000
2011,VCT,"St Vincent and the Grenad",1,0,275,0,0,275,0
2011,TJK,Tajikistan,1,0,2130,0,0,2130,0
2011,TZA,"Tanzania Uni Rep",3,37,59000,200,6776,65976,0
2011,THA,Thailand,2,877,10216110,0,0,10216110,40317000
2011,TUR,Turkey,1,8,0,3,0,3,0
2011,UGA,Uganda,1,27,63075,0,0,63075,0
2011,USA,"United States",4,17,25100,0,11000,36100,6600000
2011,VEN,Venezuela,3,17,1668,0,2000,3668,16000
2011,VNM,"Viet Nam",3,122,1361570,14,0,1361584,219002
2011,COD,"Zaire/Congo Dem Rep",2,0,6000,0,2000,8000,0
2011,ZMB,Zambia,1,0,1375,0,0,1375,0
2011,ZWE,Zimbabwe,1,0,0,0,0,0,0
2012,AFG,Afghanistan,6,149,48394,311,2445,51150,0
2012,DZA,Algeria,2,69,0,101,0,101,0
2012,ARG,Argentina,1,6,10000,0,0,10000,0
2012,AUS,Australia,2,4,16000,0,0,16000,588000
2012,BGD,Bangladesh,2,139,5398475,0,0,5398475,0
2012,BEN,Benin,1,4,55000,0,0,55000,0
2012,BOL,Bolivia,1,13,69085,0,0,69085,0
2012,BRA,Brazil,1,0,210000,0,0,210000,171000
2012,BGR,Bulgaria,1,5,37950,0,0,37950,4400
2012,BFA,"Burkina Faso",1,18,0,0,21000,21000,0
2012,KHM,Cambodia,1,14,71500,0,0,71500,0
2012,CMR,Cameroon,2,25,20000,0,31980,51980,0
2012,CAN,Canada,1,0,1500,0,0,1500,34000
2012,TCD,Chad,2,20,613631,0,0,613631,10000
2012,CHL,Chile,1,0,4300,0,0,4300,3100
2012,CHN,"China P Rep",12,622,32992000,0,0,32992000,14970333
2012,COL,Colombia,4,85,120664,18,8000,128682,102000
2012,COM,Comoros,1,4,64987,150,0,65137,5000
2012,COG,Congo,2,19,2025,89,7500,9614,0
2012,CRI,"Costa Rica",1,6,9523,0,0,9523,0
2012,HRV,Croatia,1,0,1500,0,0,1500,0
2012,CUB,Cuba,1,2,2859,0,141,3000,0
2012,DOM,"Dominican Rep",2,0,3070,0,11500,14570,0
2012,ECU,Ecuador,1,29,71790,70,0,71860,0
2012,FJI,Fiji,2,15,19545,0,0,19545,89000
2012,GAB,Gabon,1,1,77845,0,0,77845,0
2012,GEO,Georgia,1,5,100000,18,0,100018,3000
2012,GRC,Greece,1,1,200,0,0,200,0
2012,HTI,Haiti,3,42,26465,0,0,26465,0
2012,IND,India,6,279,4210860,0,0,4210860,244000
2012,IDN,Indonesia,7,41,32295,25,1000,33320,0
2012,IRN,"Iran Islam Rep",1,7,1000,0,0,1000,0
2012,IRQ,Iraq,1,4,0,0,0,0,0
2012,ITA,Italy,1,4,500,0,700,1200,15000
2012,JPN,Japan,1,30,48135,0,0,48135,1400000
2012,KAZ,Kazakhstan,1,0,9400,0,0,9400,0
2012,KEN,Kenya,1,73,280670,0,0,280670,100000
2012,PRK,"Korea Dem P Rep",1,88,92945,144,0,93089,11400
2012,KGZ,Kyrgyzstan,1,0,11000,0,0,11000,0
2012,MWI,Malawi,2,4,90735,0,0,90735,0
2012,MMR,Myanmar,1,2,85000,0,0,85000,0
2012,NAM,Namibia,1,0,650,0,0,650,0
2012,NPL,Nepal,1,72,0,5,0,5,1000
2012,NIC,Nicaragua,1,9,29500,0,0,29500,0
2012,NER,Niger,1,91,530952,0,0,530952,2750
2012,NGA,Nigeria,1,363,7000000,867,0,7000867,500000
2012,PAK,Pakistan,3,518,5047662,2902,0,5050564,2500000
2012,PSE,"Palestine (West Bank)",1,0,1500,0,0,1500,0
2012,PAN,Panama,2,6,9416,32,0,9448,0
2012,PNG,"Papua New Guinea",1,5,200000,0,0,200000,27000
2012,PRY,Paraguay,1,0,78945,0,0,78945,4000
2012,PER,Peru,2,14,260000,29,50000,310029,0
2012,PHL,Philippines,8,157,4578850,16,35762,4614628,75330
2012,RUS,Russia,4,179,37397,3910,5500,46807,617000
2012,RWA,Rwanda,1,5,11160,0,0,11160,0
2012,SAU,"Saudi Arabia",1,19,0,0,0,0,0
2012,SEN,Senegal,1,19,57000,0,0,57000,10000
2012,SVN,Slovenia,1,0,12000,0,0,12000,265000
2012,SLB,"Solomon Is",1,0,4836,0,0,4836,0
2012,SOM,Somalia,2,31,12200,0,20000,32200,0
2012,ZAF,"South Africa",1,13,125000,0,0,125000,200000
2012,SSD,"South Sudan",2,47,157000,0,0,157000,0
2012,ESP,Spain,1,10,600,35,0,635,395000
2012,LKA,"Sri Lanka",1,53,447000,21,0,447021,1200
2012,SDN,Sudan,1,35,135000,135,0,135135,0
2012,TWN,"Taiwan (China)",1,6,35000,0,0,35000,16900
2012,TJK,Tajikistan,1,0,5556,0,0,5556,760
2012,TZA,"Tanzania Uni Rep",1,10,0,0,0,0,0
2012,THA,Thailand,1,0,235545,0,0,235545,0
2012,TUR,Turkey,1,13,0,0,0,0,0
2012,UGA,Uganda,1,0,15000,0,0,15000,0
2012,GBR,"United Kingdom",5,8,3785,0,0,3785,2946000
2012,USA,"United States",1,2,300,0,0,300,174000
2012,VEN,Venezuela,1,0,11000,0,0,11000,93000
2012,VNM,"Viet Nam",1,34,0,40,17500,17540,30000
2012,COD,"Zaire/Congo Dem Rep",1,1,3525,0,1010,4535,0
2013,AFG,Afghanistan,4,113,17095,2,0,17097,0
2013,AGO,Angola,1,9,1000,0,0,1000,0
2013,ARG,Argentina,1,52,350000,0,0,350000,1300000
2013,AUT,Austria,1,4,200,0,0,200,1000000
2013,BHS,Bahamas,1,0,1000,0,0,1000,45000
2013,BEN,Benin,1,0,32735,0,0,32735,0
2013,BOL,Bolivia,2,99,483995,0,0,483995,2500
2013,BWA,Botswana,1,12,4210,0,0,4210,0
2013,BRA,Brazil,5,119,204066,144,43200,247410,541500
2013,BFA,"Burkina Faso",1,2,11383,13,0,11396,0
2013,KHM,Cambodia,1,200,1500000,0,0,1500000,500000
2013,CMR,Cameroon,1,0,805,0,0,805,0
2013,CAN,Canada,1,4,100000,0,0,100000,5700000
2013,CAF,"Central African Rep",1,0,32993,0,0,32993,0
2013,CHN,"China P Rep",14,637,7594000,30,90000,7684030,16598600
2013,COL,Colombia,1,7,39000,0,0,39000,0
2013,CUB,Cuba,1,2,227,0,0,227,0
2013,CZE,"Czech Rep",1,15,1300000,0,0,1300000,828552
2013,DOM,"Dominican Rep",1,0,0,0,0,0,102
2013,ECU,Ecuador,1,0,25567,0,0,25567,0
2013,ETH,Ethiopia,1,0,51500,0,0,51500,2200
2013,FRA,France,1,2,2000,0,0,2000,655000
2013,GMB,"Gambia The",1,2,3300,0,0,3300,0
2013,GEO,Georgia,2,0,25000,0,0,25000,0
2013,DEU,Germany,1,4,6350,0,0,6350,12900000
2013,GHA,Ghana,1,5,25000,0,0,25000,0
2013,GIN,Guinea,1,0,11106,0,0,11106,0
2013,HTI,Haiti,1,6,0,0,33265,33265,0
2013,HUN,Hungary,1,0,48565,0,0,48565,0
2013,IND,India,5,6453,3415000,4473,0,3419473,1360000
2013,IDN,Indonesia,9,86,577416,0,0,577416,3000000
2013,IRQ,Iraq,1,11,0,0,0,0,0
2013,ITA,Italy,1,18,2700,0,0,2700,780000
2013,JPN,Japan,1,5,3633,0,0,3633,0
2013,KEN,Kenya,4,128,115780,20,0,115800,36000
2013,PRK,"Korea Dem P Rep",1,51,800000,2,48688,848690,0
2013,LAO,"Lao P Dem Rep",2,23,574176,77,0,574253,121000
2013,LBY,"Libyan Arab Jamah",1,16,2000,0,0,2000,0
2013,MKD,"Macedonia FRY",1,1,4911,0,0,4911,0
2013,MWI,Malawi,1,3,33000,0,0,33000,0
2013,MYS,Malaysia,1,4,75000,0,0,75000,0
2013,MLI,Mali,2,37,46000,0,0,46000,0
2013,MRT,Mauritania,1,8,4225,0,2305,6530,0
2013,MUS,Mauritius,1,11,0,82,0,82,0
2013,MEX,Mexico,1,13,0,0,0,0,0
2013,MOZ,Mozambique,1,119,240000,0,0,240000,30000
2013,MMR,Myanmar,1,7,73300,0,0,73300,0
2013,NAM,Namibia,1,0,14500,0,0,14500,0
2013,NPL,Nepal,2,195,12474,35,4314,16823,0
2013,NIC,Nicaragua,1,27,14149,0,0,14149,0
2013,NER,Niger,2,32,181029,0,0,181029,64724
2013,NGA,Nigeria,1,19,81506,0,0,81506,0
2013,PAK,Pakistan,2,268,1496870,912,0,1497782,1500000
2013,PSE,"Palestine (West Bank)",1,5,12500,0,0,12500,0
2013,PNG,"Papua New Guinea",1,0,35000,0,0,35000,0
2013,PRY,Paraguay,1,0,61400,0,0,61400,0
2013,PER,Peru,2,68,180734,387,0,181121,0
2013,PHL,Philippines,5,105,4500279,59,0,4500338,2234788
2013,ROU,Romania,1,9,5400,0,0,5400,11000
2013,RUS,Russia,2,4,35635,0,0,35635,1000000
2013,SAU,"Saudi Arabia",2,39,1021,0,0,1021,0
2013,SEN,Senegal,1,8,163212,94,0,163306,0
2013,SRB,Serbia,2,0,3000,0,0,3000,0
2013,SVK,Slovakia,1,1,0,0,0,0,0
2013,SLB,"Solomon Is",1,0,10227,0,0,10227,0
2013,SOM,Somalia,2,7,105000,0,0,105000,0
2013,SSD,"South Sudan",2,99,581000,0,0,581000,0
2013,ESP,Spain,1,0,600,0,0,600,0
2013,LKA,"Sri Lanka",2,110,73946,15,0,73961,0
2013,LCA,"St Lucia",1,6,19984,0,0,19984,0
2013,VCT,"St Vincent and the Grenad",1,12,16885,37,500,17422,108000
2013,SDN,Sudan,1,76,500000,133,0,500133,7000
2013,THA,Thailand,3,84,3500000,0,15254,3515254,579000
2013,UGA,Uganda,1,13,25445,0,0,25445,3100
2013,UKR,Ukraine,1,2,265,0,1995,2260,21000
2013,GBR,"United Kingdom",1,2,600,0,0,600,1500000
2013,USA,"United States",7,31,29325,0,5400,34725,2275000
2013,VNM,"Viet Nam",6,141,2158865,66,2070,2161001,78500
2013,YEM,Yemen,1,40,49082,10,0,49092,0
2013,ZMB,Zambia,1,0,1800,0,0,1800,0
2013,ZWE,Zimbabwe,1,125,9700,0,0,9700,0
2014,AFG,Afghanistan,2,512,140000,135,10000,150135,0
2014,ARG,Argentina,2,3,5203,0,0,5203,62000
2014,BGD,Bangladesh,1,59,2800000,447,0,2800447,150000
2014,BIH,Bosnia-Hercegovenia,3,25,1000000,0,0,1000000,436580
2014,BRA,Brazil,3,45,550600,52,0,550652,0
2014,BGR,Bulgaria,4,20,7847,0,0,7847,48000
2014,BDI,Burundi,1,96,0,182,12500,12682,0
2014,KHM,Cambodia,1,45,57950,0,0,57950,0
2014,CMR,Cameroon,1,0,2120,0,1380,3500,0
2014,CHN,"China P Rep",11,381,17072700,0,420000,17492700,8237000
2014,COL,Colombia,4,77,54214,0,0,54214,0
2014,CIV,"Cote d'Ivoire",1,39,0,0,0,0,0
2014,HRV,Croatia,2,3,9116,0,0,9116,0
2014,DOM,"Dominican Rep",1,1,300,0,0,300,0
2014,FRA,France,3,14,4000,0,0,4000,0
2014,GEO,Georgia,1,0,120,0,0,120,0
2014,GRC,Greece,1,0,0,0,0,0,0
2014,GTM,Guatemala,1,0,0,0,0,0,0
2014,HTI,Haiti,1,12,30000,0,0,30000,0
2014,HND,Honduras,2,4,23000,0,0,23000,1400
2014,HUN,Hungary,1,0,6500,0,0,6500,0
2014,IND,India,8,586,4076500,0,650000,4726500,16163000
2014,IDN,Indonesia,7,71,431837,0,5250,437087,756000
2014,IRN,"Iran Islam Rep",1,37,440000,0,0,440000,49000
2014,KAZ,Kazakhstan,1,5,2700,9,0,2709,0
2014,KIR,Kiribati,1,0,220,0,0,220,0
2014,KOR,"Korea Rep",1,13,0,0,0,0,0
2014,LAO,"Lao P Dem Rep",1,0,750,0,0,750,0
2014,MWI,Malawi,1,0,44850,0,0,44850,0
2014,MYS,Malaysia,1,17,230000,0,0,230000,284000
2014,MHL,"Marshall Is",1,0,360,0,0,360,0
2014,MAR,Morocco,1,11,0,0,0,0,0
2014,MOZ,Mozambique,4,22,143760,76,0,143836,0
2014,MMR,Myanmar,2,0,40000,0,0,40000,0
2014,NPL,Nepal,2,24,2400,0,0,2400,0
2014,NIC,Nicaragua,1,0,60345,0,0,60345,0
2014,NER,Niger,1,36,165578,0,0,165578,0
2014,NGA,Nigeria,1,15,10000,0,0,10000,0
2014,PAK,Pakistan,1,367,2470000,673,0,2470673,2000000
2014,PAN,Panama,1,9,116,0,0,116,0
2014,PRY,Paraguay,1,0,231360,0,0,231360,0
2014,PER,Peru,1,0,6300,0,2700,9000,0
2014,PHL,Philippines,2,4,102955,0,0,102955,0
2014,PRI,"Puerto Rico",1,1,0,0,0,0,0
2014,ROU,Romania,2,4,525,0,0,525,0
2014,RUS,Russia,1,0,22545,0,0,22545,15000
2014,SRB,Serbia,3,55,1610000,0,0,1610000,2172355
2014,SYC,Seychelles,1,0,4435,0,0,4435,0
2014,SVN,Slovenia,1,2,600,0,0,600,0
2014,SLB,"Solomon Is",1,47,52000,0,0,52000,24000
2014,SOM,Somalia,1,0,21000,0,0,21000,0
2014,ZAF,"South Africa",1,32,7185,0,0,7185,85000
2014,LKA,"Sri Lanka",2,68,1204000,29,0,1204029,0
2014,SDN,Sudan,1,77,260000,227,0,260227,0
2014,SWZ,Swaziland,1,11,400,0,0,400,0
2014,TJK,Tajikistan,2,20,12760,38,425,13223,0
2014,TZA,"Tanzania Uni Rep",2,31,40000,0,0,40000,0
2014,THA,Thailand,4,29,131280,8,0,131288,10000
2014,USA,"United States",1,0,0,0,0,0,90000
2014,COD,"Zaire/Congo Dem Rep",1,30,0,0,3750,3750,0
2014,ZMB,Zambia,1,0,0,0,20000,20000,0
2014,ZWE,Zimbabwe,2,14,2500,2,0,2502,20000
